-------------------------------------------------------------------------------------------------------------------------------------------------------------------------------------------------------E
-------------------------------------------------------------------------------------------------------------------------------------------------------------------------------------------------------X
--------------------------------------------------------------------------------------------------------------------------------------------------------------------------------------------------------
-------------------------------------------------------------------------------------------------------------------------------------------------------------------------------------------------------B
--------------------------------------------------------------------------------------------------------------------------------------------------------------------------------------------------------
--------------------------------------------------------------------------------------------------------------------------------------------------------------------------------------------------------
---E------------XT-XX--------E---o-o---B?--------------T-BMB?-------BT-o----------X--M----------E-----o-o-----X-XT-o------X--------E--oo----XXX-TEXo-----X??-oo------?-X-X-B?BM--B?B--XXXX-----XX--E----
----------M------B-------BMB---------------------------M-?-X----------oT-o--------------?----------E--E----oT-B-E----------oo--oo-o----X--?B?B----------------B?B-------------BT-X--------o------------v
------XXXXXXX-------------------Eoo-----MB----ooooo-----------------o---------T-X---------E-------XXX--?B------oo--------XX----oooo------T--------------o--------------?B?BT----oE---X-T-XX?B?BEEX---MTf
----------------------------E----E--------------?B?B-X-----------MT-------------T-X--X-----X-?---B?------------------------------XXX-------X---------M---------X------oo-----X-X-X--------EM--BXXXX----f
------------------------?B?B----XXX---X--X-X-X-------------o---------XT-XE----ET-T-o-o-?B----------o-o--o-T-XXX---------E-XXX--XXX--X--B-B-oT-o--M--?B?XXXXXXX-XXo--X---XX--B-B-M------XXXX-------BX---f
--------------------------------MB----XXX---------------ET-X-----------------E-|-|--E------X-------|--?------------EE-----oTEX--------------|--------------------T--?X--XXXX--?-?---BMBX------o--XXX-T-f
--E------XX--X------------------------oooo---?E----------|----?-------|------E-|-|---------X-------------------------E-ooo-|---------------X----------ooo-?B?B---|-o--------M------EE---|----X--XT-B-|-f
--X-XXXX-X--?B-X---X-------------T--------XX-X----?B?BM--|------------|--oooo--|-|--E------------|-|------|-------XX-------|---T-oooooo---X---------E-X------o---|-------------------X--|---B----|---|-f
m----?---------------------------|---B?BXXXX-------------|--------XXX-|-|------|-|---------------|-|-B?--------T-----------|---|--X---X----E|-T-X--------B-BT----|-------B?-?-?-X---|--?B?B?XXXXX|-XX|-X
XXXXXXXXXXXXXXXXXXXXXXXXXXXXXXXXXXXXXX-XXXXXXXXXXXXXXXXXXXXXXXXXXXXXXXXXXXXXXXXXXXXXXXX-XXXXXXX-XXXXXXXXXXXXXXXXXXXXXXXXXXXXXXXXXXXXXXXXXXXXXXXXXXXXXXXXXXXXXXXXXXXXXXX-XXXXXXXXXXXXXXXXXXXXXXXXXXXXXXXX
