o-----------------------?-----------B------------------------------------B------------------------E----B----------------B------------E---------B------------------------E--------M-B---------E--B-------
X--------------------------------------------------------------------------------E------------B---------------o-----------------------------------------EE----------------------E-------------B---------
--------------------------------------B--------B------------------T----------B-----E--B----------------------------o---------T-----BM---E------------------B--------------E-E-T-------------------------
--------B---------------T--------------------------------?--------B-----------------------------------------------E--------------------------------T----B---------B-----------------------------------B-
--------------T------------------------------------------------------------------------------B-------------------------------------B-------------------T---B------E---X---------------------------E-----
-------------------B----------------------------------------E---------------TB-----------------E----------------E------B----T---------------B-----------------------------------------------------------
----------------BET-------------------B------------------------------------------------------E--------E---------------------B--------------------E-----------------T------------------------------------
X-----------------------E---------------------------------------B---------------------B-------------------------------E----------------B-------------------------------------B-------------------------v
---E-------------------------E----------B--------------------------------E---o-----------------------B-E--------B----------------------------------------------------B----B---BB------------------------
o--------------------------------------E-B------------------------------------------------------------------------------------------------------E--------------B----------------------------------------
B----------------B------E-----E-----------------------------B----------------------E---------B------E------B--------------------------------T----B------------E-------------------------------------E---
------------------------T---B---------------------------E-------------------------------------------------------E--------TB-------------B---|------------------------------B----------------------------
------E-----------------|-----E-----------------------------E--|----------------------------------|----------T----------------E----T--------|-----------------------------------------------------BT----
----------------------B--------------T--B----------------------|--B----T--------------------------|----------|-----------|---------|--------|------------------------------------B----------B-----------
m-------------B------E---------------|-------------------------|-------|--T----------B--B--------E|----------|--------------E------|---B-E--|------T--E-------------T-----------------E------------|----
X-XXXXX-X-XX-X---XX---X--X-----X-----XX--XXXX--X-X--XX---X-X--------X--X--X--XX-XX-----X-------X--X---XX---X--X----X-X-X---X-X--X-X---XX---XXXX-X-XXXX-XX--XX-XX-------------X--XXX-X----------XX-XXXXXX
