B-----------------------------------------------------------------------------------------------------------B--------------------------E----------------E--B---B-------------------------B-------------T
--------------T-------E-------E----------E--------B------------------------E-------------B--------------T--------------------------E---B--------E------------------------------------------------------B
B--B-B--------|-------------------------------B-------BB-T----------------------------------------------|---T----------------------B----T------------T---------B------------T-------------B---B---B-E--M
--------------|------------------------------------------|------------------------------------B---------|---|----------M---------------E|---T--------|----------------------|----T----B--B------E--B----
--------------|------------------------|-------T---T---B-|--------------------E----------B--------E-----|---|-------------------------B-|---|--------|---B-------------T----|----|---------B------------
o-------------|----B------E--------------------|--E|----B|------------------------------B--------T------|-----------------B-----T-------|---|--------|------T----------|--E-|----|-------B--------------
X-----T-------|----E--T----------------------------B---------------------B--E------B--T----------|------|-------T------------B--|-------|---|--------|----|-|----------|---B|----|-T-----------B--------
------|-------|----B--|-------------T-M------------------------------------------------E-------|-|------|-------|---------------|-----------|--------|------|---B------|----|------|--E----------BE----v
------|--B----|--B----|----------------------------E-B----------T---------T--------------------|-|----T---------|------------E-----E----B------------|------|----------|--------E--|----------------T--B
------|-------|-------|-----------------------------------------|-----T---|--------------------B-|?---|-----B--------B---------E------------------B--|------|--B-------|---------BE|----------------|---
--B------BB---|-------|--T----------------------B-------B-----------------|--E-------------E-----|----|-----------------------------B----------------|------|----B--|--|--|-----B--|---------T------|---
----------B---|--E----|--|----EB------------------------------------B-----|--B--B----------E----B|----|-?--------------------------------------------|------|-------|--|--|--------|--|------|------|-B-
-----T------------B---|--|-----B-----------------------|-------------B----|-----------B--T-------|----|----B----------T------B--T-B-----B--------E---|-------|---------|--|--------|---------|------|--o
o--E-|---B----|----------|-BE------------B-B---|-------|-BE-E----T----|---|--------------|----B--|----|---------------|-----B---|-----E---B-------B----------|----T----|--|--------|T-|----------------M
m----|--------|----------|--------------E---T--|--E--------------|--------|--------------|-------|----|------E--------|---------|-------------|------|-------|----|-|--|--|--------|--|------|----------
XXXXXXX-XXXX--XX-XXXXX-X-XX-X-X-X-XX--XXX-X------XX--XX--XXX-X-X-X--X-XXXXXXXX--X--X-X----X-X---XXX---XX-X-XXX-XX----X-X--X---XX-X-XX--X------X----XX----XX-X--X-X--X-XXX---X--XX-XXX-XX---XX---X-XXXXXX
