----------------------------B-----------------------------E---B----?-----------M-------------------------------------B-----------------------------E-----------------B------------------------B----B----
------E-----B---------------------------------------------------------------------B----------------------------B-------E--------------------------------------------------------------------------------
-------------------------T----------------------------------------------------B------------------B-----------------------------------------o--------------------------BB-----------------E-------B------
--------|----------------|------T--------B----------------------------------------------------------------------------------------------|------E|--------------------B-------E--------------------------
o----BB-|-----------E----|------|------------------B-------------T-------------------------------------------------------B--------T--X----------|--------------------E--------------------------------T-
--------|----------------|------|----B-----------------B-----T------------B-------------------------B-----------------------------|----E---------------------T---------------------------------T------|-
----------T--------------|--------B---------T----------------|------------------------T---------------B--B------------------------|--------------------------|---E---EE-------T---E--------B---|-B----|-
o------B--|------T----E--|------------------|--------------------------------X--------|-------------------E---T--B----------------|------------------B-----B-|-B--------------|---B------------|-B----|-
M----B--B-|------|-------|------------------|-----------------------------------------------------------------|--B--------B----------T-T---------------------|----------E-----|-B-E-------------------|B
B--------B|-----E----B--B|------------------|-----B--B-----------------------E-T------------------------------|-----------------B----|-|---------------------|-----------------------------------E----|-
----------------E----B-B-|-------------|----|-------------B-------------|-----B|--------E----E---------------------------------------|-|----------B----------|----------BB-E----------EB-B-------E----|-
B---------|--------------|-------------|-B--|--------------------------E--B----|--BB-----|------------B-------|-------------------|--|-|--------------------------------------|--------------T--------|-
----E---B-|--------------|------------------|-----------------------------------------------E--B--------------|--T----------------|--|-|----B---B-----------B---B-------EB-B--------T---B----|--------|-
B---------|------E-------|-----------BE-----|---B------------B-----------------------------------E------T-----|--|-----T----T--B-----|-|--------------------------------------------|------------B----|-
mT--------|------E------------------E--|----|---------B---------------------B----------------------|----|---B-|--|-----|----|--------|-|-T--------------------------T---------------|----E------------|-
XXXXXXX-X-XX-X--X-X-X--XXXX-X-X-X-X-X---XX-X-XXXX-X-X-X-X--XXXX-XX--X-X---XXX-XXX--X-X---X-X--XXXX-X--X-X---XXX--XXXX-XXXXX-X--XX--XX--X-X-X---XXXX--X-X---X-----X-X-X---X---X------X-X--X--------XXXXXX
