--------------------------------------------------------------------------------------B-----------------------------------------------------------------------------------------------------------------
----------------------------------------------------------------------------------------------------------------------------------------------------???-------------------------------------------------
-------------------------------------------------------------------------------------------------------------?--------------------------------------------------B---------------------------------------
-------------------------------------------------------------------------------------------------------------------------------------------------------------------------------------------T------------
------------?---------------------------------------??-------------------------------------------------------------------------------------------------------------------------------------|------------
-------------------------------------------------------------------------------X-----------------------------------------------------------------------------------------------------------|------------
-------------------------------------------------------------------------------XX----?-------------------------------------------------T---------------------------------------------------|------------
----------------------------------------------------------B--------------------XXX-----------------------------------------------------|---------------------------------------------------|-----------v
-------------------------------------------------------------------------------XXXX--?-------------------------------------------------|---------------------------------------------------|-----------f
-------------------------------------------------------------------------------XXXXX---------------------------------------BBB---------|-------------------------------------------B-------|-----------f
-------------------------------------------------------------------------------XXXXXX--------------------------------------------------|---------------------------------------------------|-----------f
-T----------------------------------------------------------------------o------XXXXXXXXXXXXX-------------------------------------------|---------------------------------------------------|-----------f
-|-----------------------------------------------------------------------------XXXXXXXX------------------------------------------------|------------------------------o--------------------|----T------f
-|---X-------------------------------------------------------------------------XXXXXXXXX-----------------------------------------------|---------------------------------------------------|----|--B---f
m|--XX-------------------------------------------------------------------------XXXXXXXXXX------------------------------X---------------|---------------------------------------------------|----|------X
X|XXXXXXXXXXXXXXXXXXXXXXXXXXXXXXXXXXXXXXXXXXXXXXXXXXXXXXXX------XXXX------XXXXXXXXXXXXXXXXXXMXXXXXXXXXXXXXMXXXXXXXXXXXXXXXXBBBXXXXXXXXX|XXXXXXXXXXXXXXXXXXXXXXXXXXXXXXXXXXXXXXXXXXXXXXXXXXX|XXXX|XXXXXXX
