--------------------------------------------------------------------------------------------------------------------------------------------------------------------------------------------------------
--------------------------------------------------------------------------------------------------------------------------------------------------------------------------------------------------------
--------------------------------------------------------------------------------------------------------------------------------------------------------------------------------------------------------
----X---------------------------------------------------------------------------------------------------------------------------------------------------------------------------------------------------
--------------------------------------------------------------------------------------------------------------------------------------------------------------------------------------------------------
--------------------------------------------------------------------------------------------------------------------------------------------------------------------------------------------------------
--XXXXX-------------------------------------------------------------------------------------------------------------------------------------------------------------------------------------------------
--------------------X--X-------------------------------------------------------------------------------------------------------------------------------------------------------------------------------v
-------------------XX-XX-------------------------------------------------------------------------------------------------------------------------------------------------------------------------------f
-----------X------XXXXXX-------------------------------------------------------------------------------------------------------------------------------------------------------------------------------f
-----T----XX-----XXXXXXX-------------------------------------------------------------------------------------------------------------------------------------------------------------------------------f
-----|---XXX?---XXXXXXXX-------------------------------------------------------------------------------------------------------------------------------------------------------------------------------f
-----|--XXXX---XXXXXXXXX-------------------------------------------------------------------------------------------------------------------------------------------------------------------------------f
-----|-XXXXX--XXXXXXXXXX--T----------------------------------------------------------------------------------------------------------------------------------------------------------------------------f
m----|XXXXXX-XXXXXXXXXXX--|--------------------------E----------------------------------------BBBBBBBB-------------------------------------------------------------------------------------------------X
XXXXX|XXXXXXXXXXXXXXXXXXXX|XXXXXXXXXXXXXXXXXXXXXXXXXXXXXXXXXXXXXXXXXXXXXXXXXXXXXXXXXXXXXXXXXXXXXXXXXXXXXXXXXXXXXXXXXXXXXXXXXXXXXXXXXXXXXXXXXXXXXXXXXXXXXXXXXXX------XXXXXXXXXXXXXXXXXXXXXXXXXXXXXXXXXXXX
