-------------------------X---------------------------------------------------------o----o-----o-----------------------------------------------------------------------?------------------------------B--
----------------------------------------------------------------------------------------------------------------------------------o---------------------------------------------------------------------
--------------------------------------------------------------------------------------------------------------------------------------------------------------------------------------------------------
-------------------------------------------------------------------------------------------------------------------------------------------------------------------------------------T------------------
-------------------???????-----------------------------------------------------------------------------------------------------------------------------------------------------------|------------------
----------------X--------------------------------------------------------------------------------------------------------------------------------------------------------------------|------------------
-------------------------------------------------------------------------------------------------------------------------------------------------------------------------------------|------------------
-------------------------------------------------------------------------------------------------------------------------------------------------------------------------------------|----------------Xv
-------------------------------------------------------------------------------------------------------------------T-----------------------------------------------------------------|----------------Tf
--------------T----------------------------------------------------------------------------------------------------|-----------------------------------------------------------------|-X--------------|f
---T----------|--------------------------------------------------------------------------------------X-------------|---------------------------------------------T--X----------?-----|XX---------????X|f
---|----------|-----XXX----------------------------------------------------------------X-------------XX------------|---------------------------------------------|-------------------|XX------------XX|f
---|----------|------------------------------------------------------------------------XX---T--------XXX?----------|---------------------------------------------|-------------o----X|XX-----------XXX|f
---|----------|------------------------------------------------------------------------XXX--|--------XXXX----------|---------------------------------------------|-----------------XX|XX----------XXXX|f
m-E|----------|-----------X------------------------------------------------------------XXXX-|------E-XXXXX---------|------------------E--------------------------|----------------XXX|XX-X-------XXXXX|X
XXX|XXXXXXXXXX|XXXXXXXXXXXXX--XXXXXXXXXXXXXXXXXXXXXXXXXXXXXXXXXXXXXXXXXXXXXXXXXXXXXXXXXXXXXX|XXXB----XXXXXX-XX----X|XXXXXXXXXXXXXXXXXXXXXXXXXXXXXXXXXXXXXXXXXXXXX|XXXXXXXXX---XXXXXXX|XXXXXXXXXXXXXXXX|X
