-------------------------------------------------------------------------------------------------------------------------------------------------------------------------------------------------------X
-------------------------------------------------------------------------------------------------------------------------------------------------------------------------------------------------------M
-------------------------------------------------------------------------------------------------------------------------------------------------------------------------------------------------------X
--------------------------------------------------------------------------------------------------------------------------------------------------------------------------------------------------------
--------------------------------------------------------------------------------------------------------------------------------------------------------------------------------------------------------
--------------------------------------------------------------------------------------------------------------------------------------------------------------------------------------------------------
------------oooo--------------o----X-------------------?----------------------------------------------------B?B?-?B-B------------------------------?-------o-o-o-o----XXX--------------XXXXX----E-------
--------------------------------------------------------XXXXE-E--------------------------------XT-------E------------------------------o--oo-----------------------------------------XXX-X-------XX----v
----------------E---------------------------------X---T-o----E-------T-B----------------B--T---------oooo-----E-------------------o----------E---XXX------------X-B?B-----XX---------XX-X--B-B--XXXXXX-f
--?-XXXX----------oooo---o----XXX---------------E---------T-X----------------E-------------------E---XT-------o-o--?----------------X----XXE-----------oooo---E--------B?B?-------------?--------------f
----------E----------------X-XXX---------------------------XX-------ooo-------------------E---T-X--oo---?-------E------XXXX-----T---------------------------X----E--XXXX--XX-T-XXXXX--X--B------X------f
------------------?---?-?B?X----E------E-----------------oo-?-----M---------------X---------?T|----o---BM-----------------------|--------------T-T---X----XXXE--X---XXXX-----|-X----oooX-X--E-?B?B?----f
----------------------X--------XXT-X----------X--------X-----------E-------------------------|---E---?B?------E------XXXMBT---E-|---T----------|-|-?T--T-B---X-------M-?--B?B?----------------X--------f
----------------------------ooooo|------T-oo-------X-X--------------------------?-?B?B-------|---XXXXX----o-----o--------E|-----|B--|----------|-|--|--|-|--E----------X-----|---------X---------------f
m------------------E-------------|----o-|--------XX----X-XX---------------XX-XXXXX---M-------|-----Eooo-------------------|-----|---|----------|-|--|--|-|-X----B?BE--XX-XXXXXX----ooooo--?-?-oooo---E-X
XXXXXXXXXXXXXXXXXXXXXXXXXXXXXXXXXXXXXXXXXXXXXXXXXXXXXXXXXXXXXXX-XXXXXXXXXXXXXXXXXXXXXXXXXXXXXXXXXXXXXXXXXXXXXXXXXXXXXXXXXXXXXXXXXXXXXXXXXXXXXXXXXXXXXXXXXXXXXXXXXXXXXXXXXXXXXXXXXXXXXXXXXX-XXXXXXXXXXXXX
