--------------------------------------------------------------------------------------------------------------------------------------------------------------------------------------------------------
-------------------------------------------------------------------------------------------------------------------------------------------------------------------------------------------------------X
-------------------------------------------------------------------------------------------------------------------------------------------------------------------------------------------------------X
-------------------------------------------------------------------------------------------------------------------------------------------------------------------------------------------------------X
-------------------------------------------------------------------------------------------------------------------------------------------------------------------------------------------------------X
-------------------------------------------------------------------------------------------------------------------------------------------------------------------------------------------------------o
---------------------------E------E-----------------------------E---------------------------------------------------E-MBMB------------------E------------------------------------------------X----------
--------------------------------E-------------------B?B---E------------------------------------------------------------------------------?B?B--M-E----------------------------------------T------------v
----------------XX-------o-o-oo-------XX--------X---------------E--M------X--X----M----T---------------BT-X----?-MB-------XX--?--------E---------------?B?--E-------X-Xo-o-E-----E--B?B?----E--E--X-XX-f
---------------E----o--X----B?B-----------------?------XXX---XX--------o-ooo--------E-------oT----X-X--X------?-XXXXXT---------XT----T-XXX-----oo------E----------E----XXX-o-o--E--?T--XX----X-X-------f
--T-X----XT------E------X----------------------------E--------XE-B----------X----------E-?B?B?-X--------------B?B-B?-?TEB-XXXXX-XXX---X-----oo-oB------?MT-X---------B?B--------B?B------TT-XXX-XX-X-T-f
--|--?T-B-|--------------E---E--E-------X---------XXX---E-----------XXXX--E-------XX-XX------oo-----------------E-----|-XX---E------X---------X---E---XT-|-------BXXX-------------XT-X---||----------|-f
----?-|---|--E----------------------------------|-----------B-B-?B?----E------XXX---XXX-M---------XX---------X--X---XX|-T-E-B?-MBM-?B?--------o--------|-|---B--M------X---XXX--|--|-----||--M-----o---f
------|--------------E-----B-------------E------|-?-?BM-Xooo---o------------------------------------------------------|-|------------------------------|-XX-----------B|-B-X-XXX|--|---E-||----------|-f
m-|---|-----?------o-o--------------------------|-------------------E------E-----E--------E--ooo-------B--BM---?B?----|-|------------------------------|-|-X-X-X-------|-XXX-X--|--|XXXXX-|--o-------|-X
XXXXXXXXXXXXXXXXXXXXXXX-XXXXXXXXXXXXXXXXXXXXXX-XXXXXXXXXXXXXXXXX-XXXXXXXXXXXXXXXXXXXXXXXXXXXXXXXXXXXXXXXXXXXXXXXXXXXXXXXXXXXXXXXXXXXX-XXXXXXXXXXXXXXXXXXXXXXXXXXXXXXXXXXXXXXXXXXXXXXXXXX-XXXXXXX-XXXXXXX
