--------B-----X------?----------------X--o---------?---------------X---------------M-----XM-----E-----------------B----------o----M-X--------X----------B------oX-?--M-----XX-----X----TB--------o--E---
---o--------X------------------B------------o------------------------X---T----B-o----------X---X---E-----?-X----------X-------------------B----E-------X----o----X-B-----------B-------T----------M-----
--------B--------B-X-----------X----------------E-------------------M--------X-------------------------------o----------o-----------X-----------M--Xo-X--------o-------------------M------------------T-
-------------------X---M-----B------M--------?X---------?-------B--o----E----X------E----M--------------------o-M--X------------------------------o-------------------------------------B-B------X------
-----BE---B-T-------------------------o-------o------------o-----E----oXo--------B-----X-------B-----B------------------X--------------------------X----M-----------X---XX-----------------B-------X-B-X
---------EX-|o--------ooM-X-----------X--------------B-o---------o----------B-?---------?-----X---B--o--B---------------------o---X--------MB-------------------BBX--M--M--------------------o-------B--
------------|---------E----------------o--------------?--------------------X------------------------------B--E----X---o-----BE---|-----------------X------------Mo-----B----o--------------------?-----X
------------o-----B-------------------o-----------XX--X-------T-|----XX-o----------X-X-T------X----X--------------X-o--X--------X|--------E---?------T------------T-----E--B----o----oX-------------E--v
--X--B----E-|--M--Bo---------------B------X-B-?----------o---------------B-------------|----X-----------B----|---X------EX-------|---------------------T-------------o----------------------?----X---B-o
---------B-B|-E----T----------------|---o-B--o------------?---|-o-EX--B----------------|----------------BX---|--B------------------------------T-X--o--|X------T--|---?---------------M-----------------
---E--------|-----B-----X----M------|-----------|-------------|-------B-------X-----E--|--------------------------o--------------|---B------X--|---?-|-|-------|----o---------X---------------XB--------
-----------Eo---?X-----------------Xo------oTX--oM---X--------|-------T--M--B---------o---------------X-------o-----?-B----B-----|---T-o-------|o----|-X--B--B|---|-E--B--XX----------------------------
---o--------|------|--X---o-----o|--|------B|-----------B-----|-|-----|---E------------|?-------M--?----E----|---o-----------B---|--B--T--------X-|--|-|--E---||--|---------B--------------------MM----?
X-|----------X----------------------|----------o-XX---------T-|-----B-|--------B----B--|---------------------|-------------------|---|---------|--|--|--------||----------------------------T------E---T
m-|------?---------|----------------o-B------------------B-E|---------|-------------------------B------------|----B--------------|---|-|-------|--|----|------||-----------------E-B-------X------------
XXXXXXXXXXXXXXXXXXXXXXXXXXXXXXXXXXXXXXXXXXXXXXXXXXXXXXXX-XXXXXXXXXXXXXXXXXXXXXXXXXXXXXXXXXX-XXXXXXXXXXXXXXXXXXXXXXXXXXXXXXXXXXXXXX-XXXXXXXXXXXXXXXXXXXXXXXXXXXXXXXXXXXXXXXXXXXXXXXXXXXXXX-XXXXXXXXXXXXXX
