-----------------------------------E-------E-B-------------------------------------------------------------------------------------------B-------------------------------------------------------------X
X-----B----------------------B-----E-----B---------B--------------------------------------------------------T----------E----------------------E-----B--------------------B------B--B----------------B---
--B-------E---------T-----B--------E-------------------------------------------------------------?----------|--------------E----T--------------------------------------------------B----------B------B--
----------------E---|----------------------------E--------------------B----------------E--------------------|--------E----------|----------M----------B---------------------------E-------T-------------
-----------B--------|--------------------------------E--------------T---BB--B---T------B--------------------|-------------------|-----------B-------------------E-------------------------|-------------
o----------------T------------------T-------------------------------|----------B|--------------E--E---------M---------------E---|---------B---------------------B-----------------B-------|---------B--o
--------E--------|------------------|-----------------------|-------|----------------------------B-B--------|-------------------|------------E------o---B-------B--------------------|----|-------|--B--
--B--------------|---B----------T------------B-----------T----------|---------------------------------------|---|------------E----------B----------------------------T-T------------------|---------EB-v
-----------------|--------------|------------------------|----B--------B-E-------B------------------B-E---X-|---|-E-------------------------------------------------E|--BB---B-------------------------o
---------------B----B-----|-----|-------E---B------------|------T---------------------|-E---------EB-B----------|--------------|-------------------|-----------------|--------B------------------------?
X-------E-----------------------|--------B----------T----|----BE|---------------------|----E---B----E-------B---|--------------|------B-------------|----------------|-----E?-B-----------------E------?
E----------------E--------|-----|-----------------B-|----|--|------E------------------|-------------E-B---------|--------------|-------------------------E-----------|-----------B---------E------------
--------------E-----------|--T--|---T-------B-------|----|--|-------|------E----------|-BT---B------E-----------|--------|---E-|--B---------T-------|-|-------B------|--B--------------|----------------
--------------------------|--|--|---|--------------------|----------------------------|--|-B---B---E------B-----|--------|-----|------------|------E--|------B-------|--------------------B--------|--BB
m----------B----B-----B---|--|--|---|--------B--------T--|--------B-----E----------------|-------------------------B-----|---B-|-B----------|------B|-|--------------|-B---------------|-----------|----
XXXXXXXX---X--X-X--X-X---XX--X--XX-X-X----X-X--XX--X--X--X---X--X------XX--XX--XX-X-X-X--XX--X-XX-XX-X--X-X-X-X-XXXX---X-X-XXX-XXX-X--XXX-XXXX-X--XX--X----X-XXXXX--XXX-XX-X-X-X-X--X--X-XXX--XX-XXXXXXX
