-------------------------------------------------------------------------------------------------------------------------------------------------------------------------------------------------------B
X------------------------------------------------------------------------------------------------------------------------------------------------------------------------------------------------------o
o-------------------------------------------------------------------------------------------------------------------------------------------------------------------------------------------------------
--------------------------------------------------------------------------------------------------------------------------------------------------------------------------------------------------------
-------------------------------------------------------------------------------------------------------------------------------------------------------------------------------------------------------X
o-------------------------------------------------------------------------------------------------------------------------------------------------------------------------------------------------------
-------------------------------------------------------------------------------------------------------------------------------------------------------------------------------------------------------E
--E---------------------E-|-----|------|---------------------------------|----|----------------------------------------T-------|----|-------------E-----------B---BB----------B--------|----------------
---B--------------|-------|----B|-------------------------B-B------------|-E-B|----------B-------------------B---------|-------|---B------------------------|-----------------X--E-E---|-T--------------
-----------M---BB-|-------------|--------------------------------E---E---|--------B----------------B-------------------|-------|-------------E----------------------------E-----------B|-|-------E------
-------E-------------T----|-----|-------------B--------------------------|-BB------M-------------------------------B---|-------|---E-----------B------------|---B-----T----------------|-|----E---------
B----------------|---|----|----------------------------------------------|--B-----E----M--|---------T------------------|-------|----------------B-----------|---------|----E-----------|-|--------------
------E----------|---|----|-----|-------------------T-----------------B--|----------------|--------B|----------B-------|-------|--B-------------------------|---------|----------------|-|--------------
-------------B-B-----|-----------------------B------|--------T-----------------------B----|---------|------------------|------------------------------------|---BE----|-B--------------------E-|-B----T-
m-----B----------|---|----|----------|--------------|--------|----E----------------B------|---------|------------------|-------|-B--B---------B------------------B----|------------------------|------|-
XXXXXXX---XX-XX--X-X-XX--XXXX--X--X--X-X-X-X-X-XX-------X-X-X-XX--X-XX-X--XXX-X--X--X--X--XXX-X-X----XX-XXXX--X-X-X--X--XX-X--X-XXX-X--X-X-X-XX-X-X-XX------X-X------X--XX--X----X-X-X--X-X-XX-X-XXXXXXX
