----------------------------------T----------------------------------------------------------------------------------------------------------------------M-----------B----------------B--------------B--
--------------------ET------------T---E--E------------------------------------------T--T------------BB-B-----------T--------M--B-----B----------B------------------------------------------E------------
E--------------------------B------------------------------T-----------------T-B-T---------------T-------------E------------------------E-----E----------------------------------T-------B-------------B-
o---B------------------E-------------------------------B---------E-----------------------------------------------E-----------------------B-B-E-------------------------------T-------------T-----B------
----------B--------------------------------------B----------------------B-------------B------------------------B---------------------B-----E----E----------------E------B----------------------------B--
M--T-------------------------------------B-----------------------T----------B--------B------------------------------------------------------------B---------------B-------------------------------------
---B-E---------------B-------------------------E-------------------T-------------T----------------------------------------------------------------------B----B--------E---------------------------------
o-------T-----B-----B-T-----B----------------------------------------B-E------------------------B----------------E------------------------------------B---------------------------------------------E--v
----------------------E----B-------E----T------------E---------------------E------------------------------------------------------B--------E-----B------------------------------------------B-----------
---E-------------------B----------------|---------------B---------------B---B------------------------E---E-------------------------------B------------------------E------------TB--------------------|--
o-----------------------------B-----|---|------B---B---E-B------------B-----E-----------------B----?-------T------------B----------------------------------------------------o----------B------------|--
-------------------|-----------------------B----------------------------------------------------------------------------------E--------------------------------T-------B---E-E-|-----------------|---|--
----------------------B|------------|---|-B----B----|-------------------------------E--B-E-------B----T----------------B----E-----------B-B-------B--------------------E-------|-----------------|--B|--
---------B---E---------|----------------|-----B-----------B---------------------------------T-----------------BBB------B-----T------------------------------------T------------|----EB-B---------|---|--
m--------------|---|---|-----B----------|-----------------E-T-----------B----------------B---------------------E-------------|--------------------B------------|-----------E---|-------T---------|---|--
X-XXXXX-----XX---XXX--X---X-XXX---X-X--X-X-XXX-X-XX-XX-X---XXXX-X-XX--------X-XX---X-XX----X-X---XXX-X-------XXX-XX-XXX---X-XX-------X--XXX---XX-X-X--X-X-XX----XX-----X-X--XX-XXX--X-X-X---XX-X--XXXXXX
