-----------------------------------------------------------------------------------------------------------------------------------------------------------------------------------------------------T--
--------------------------------------------------------------------------------------------------------------------------------------------------------------------------------------------------------
--------------------------------------------------------------------------------------------------------------------------------------------------------------------------------------------------------
-------------------------------------------------------------------------------------------------------------------------------------------------------------------------------------------------------X
--------------------------------------------------------------------------------------------------------------------------------------------------------------------------------------------------------
-------------------------------------------------------------------------------------------------------------------------------------------------------------------------------------------------------?
---E--------------EE---------------B------E---------------?-?----------X-X---XXXXX----T----------E-Mooo-XXXB?B-XX-X--X-X----------------------------T-X---M-M---X-----XT-X-XXXXX---XX--------XXXXX----EX
------------------------------?-----------------------------X-XXX------------------------T----------?B?--B---XX--------EXXX-X-------------?---B?B?-?BXXX-------XXXX-----X--X?-?B?XXX--oooT-----X-X-----v
--E------------XX---------------------------------------XXXX-------XXX---------BMBE--E-E--------o-o--------MB-B--X-X------------------E-------------E---XXX--------T-------?TE-E--------?B--X---X----E-f
------B--MB-------X-X---?--TE---B?-------------T-X----------o-o-----XX-X--X---E---B?B?-----------------E----T----EX?---------E------B-B?---------T-o---Moo-o---XXXXX-MB--------XX-X--------M--B----X--Xf
------------X---------E-----X--------X-------MT-X----X--oT-XX-------Mooo-------T--?---X----------?------ooo------M---X--M---o--------?E---X--T---XX----------M--XX----E-T-----M----X--XXXXXXX--X--oXXX-f
-------|--------------------------------------|---E------|XXXX-----E---XXX-----|-------------TTXX----?B-M-----?B?B----B?B?---?----------XXX-------XXTEX------o----------|--ooo------T-B-------XX?B?E---f
----X--|---------------XX----T-o-oB-B---------|----------XX-----E----|B?---------------ooooo-||-----?B?B?--------------------o----------EXXXX|-----E|-?-E-------B----M--|-----------|--B--------B?B?B--f
-------|------X--X-----------|-------XT------?-------T---|------B--?-|--E------|-------------||-----------------X-----------XX-------------?-|XX-XT-|---X--------------E|----------T|--T-XXXX-------M--f
m------|--------------E------|--------|--------------|---|-----------|---------|----BMB-XTT--||--ooo-oooo------XXXXXXX------XXX-----------o--|----|-|------------------XXX---------|---|--T--T----X----X
XXXXXXXXX-XXXXXXXXXXXXXXXXX-XXXXXXXXXXXXXXXXXXXXXXXXXXXXXXXXXXXXXXXXXXXXXXXXXXXXXX-XX-XXXXXXXXXXXXXXXXXXXXXXXXXXXXXXXXXXXXXXXXXXXXXXXXXXXXXXXXXXXXXXXXXXXXXXXX-XXXXXXXXXXXXXXXXXXXXXXXXXXXXXXXXXXXXXXXXX
