--------------------------------------------------------X------------------------B-----------------------B----------------------------------------------------------------------------------------------
---------------------M---------------------------------B?-------E--------------B------B-B-------------------------------------------B------------------E----B------------------------------------------X
----------------------------------------------------B------------------------B------------------E----------E---------------------------------------B-----------B---------------------------------------X
------------------------------------B--------------------------B--------------------------B-------------------------E-----------------------------------B-------------------------------B-------B-------
--------------------B--------------------------------------B---------E-?----------------BB--------------------------------------------------------------------------------------------B----------------B
--------------E-E-------------------------------------------------------------------------------------------------------B---------------E---------------------------------------------------------------
----------------------------------------------------------------------------------------------B---------------B------------------------------E----------------------------------------------------E-----
------------------------------------------------------------------------------------------------------E-------------------------------------------------B--B-----------B-------------------------------v
----B--------------------------------B-------------------|----------E-----------------------E-----------------B----------B----------------E----T-------------------T----------E-----------|-------------
-------------------E-----------------B---B-B----E--------|---------------------------------B-----B-------------------------------|---------------------------------|----B--------------E--|-T-----------
------B--------------------------T--B----------------------B----------------------------------------------------------E----------|-------------|---------------T-|-|-------------------B--|-|-----------
---TE------------------------B---------------------------|-------------------T----------------B-----------------------E-------------------B-----------------B--|-|--------|--------E--------|----------X
---|-----------------|-----------|-----------|-----------|-----|-B-E------B--||-----------------------------------------E----B-|-|-------------|------------B---------------B--T-|--B-----|------E-----M
E---------------|----|-----------|-----------|------E-------|----------------||----------X-------B---B-------------------------|------------B--|-----------T--B|-|-|-----------|------|---|-|-----------
m------------T--|----|---------T-|-----------|--------------|-------B--------||-----------------------|------EE--------------------------E-----|------B----|---|-|-|---------|-|------|-B-|-|----------B
X-XXXXXXXXX-X-X-X-X---XX-X-X--------X---------XXX-XXX---X-X-X--X-XX-X--X----X-XX-XX----X-X----X-X---X----XXXX-----X-XX-XX-XX-----X---X-X--XX-XX-----XX--XX--X--X---XX---X----XX------XX-XX-X-X----XXXXXX
