--------------------------------------------------------------------------------------------------------------------------------------------------------------------------------------------------------
-o---------------------------------------------------------------------------------------------------------------------------------------------o------------------------o-------------------------------
----------------------------------------------------------------------------------------------------------------------------------------o---------------------------------------------------------------
---------------------------------------------------------------------------------------------------------------------------------------------------------------X---T--------------------------------X---
-------------------------------------------------------------------------------------------------------------------------------------------------------------------|-----------------T----------------o-
-T-----------------------------------------------------------------------------------------------------------------------------------------------------------------|------------XXXX-|------------------
-|-----------------------------------------------------------------------------------------------------------------------------------------------------------------|-X---------------|------------------
-|------------------------------------------------------------------------------------------------------------------------------------------------------------B----|XX---------------|-----------o-----v
-|-----------------------------------------------------------------------------------------------------------------------------------------------------------------|XX----XXX--------|-----------------f
-|---------------------------------------------------------------------------------------------------------------------------------------------------?------------X|XX---------------|--X--T-----------f
-|---------------------------------------------------------------------------------------------------------------------------------------------------------------XX|XX------------T--|-----|-----------f
-|-----------------------------------------------------------------------------------------------------------------------------------------------o--------------XXX|XX------------|--|-----|-----------f
-|---------------------------------------------------------------------------------------------------------------------------------------------M---------------XXXX|XX------------|M-|-----|-----------f
-|------------------------------------------------------------------------------------------------------------------------------------------------------------XXXXX|XX------------|--|-----|---o-------f
m|---------------------------------------------------------------------------------------------------------------------------------------------------------E-XXXXXX|XX------------|XX|X-E--|-----------X
X|XXXXXXXXXXXXXXXXXXXXXXXXXXXXXXXXXXXXXXXXXXXXXXXXXXXXXXXXXXXXXXXXXXXXXXXXXXXXXXXXXXXXXXXXXXXXXXXXXXXXXXXXXXXXXXXXXXXXXXXXXXXXXXXXXXXXXXXXXXXXXXXXXXXXXXXXXXXXXXXXX|XXXX--XXXXXXXX|--|--XXX|XX---XX----X
