--------------------------------------------------------------------------------------------------------------------------------------------------------------------------------------------------------
-o---------------------------------------------------------------------------------------------------------------------------------------------o------------------------o-------------------------------
----------------------------------------------------------------------------------------------------------------------------------------o---------------------------------------------------------------
---------------------------------------------------------------------------------------------------------------------------------------------------------------X---T--------------------------------X---
-------------------------------------------------------------------------------------------------------------------------------------------------------------------|-----------------T------------------
-T-----------------------------------------------------------------------------------------------------------------------------------------------------------------|------------XXXX-|------------------
-|-----------------------------------------------------------------------------------------------------------------------------------------------------------------|-X---------------|------------------
-|------------------------------------------------------------------------------------------------------------------------------------------------------------B----|XX---------------|-----------------v
-|-----------------------------------------------------------------------------------------------------------------------------------------------------------------|XX----XXX--------|-----------------f
-|---------------------------------------------------------------------------------------------------------------------------------------------------?------------X|XX---------------|-----------------f
-|---------------------------------------------------------------------------------------------------------------------------------------------------------------XX|XX------------T--|-----------------f
-|-----------------------------------------------------------------------------------------------------------------------------------------------o--------------XXX|XX------------|--|-----------------f
-|---------------------------------------------------------------------------------------------------------------------------------------------M---------------XXXX|XX------------|M-|-----------------f
-|------------------------------------------------------------------------------------------------------------------------------------------------------------XXXXX|XX------------|--|-----------------f
m|---------------------------------------------------------------------------------------------------------------------------------------------------------E-XXXXXX|XX------------|XX|X-E--------------X
X|XXXXXXXXXXXXXXXXXXXXXXXXXXXXXXXXXXXXXXXXXXXXXXXXXXXXXXXXXXXXXXXXXXXXXXXXXXXXXXXXXXXXXXXXXXXXXXXXXXXXXXXXXXXXXXXXXXXXXXXXXXXXXXXXXXXXXXXXXXXXXXXXXXXXXXXXXXXXXXXXX|XXXX--XXXXXXXX|--|--XXXXXXXXXXX----X
