----------------E----------B-----------E--------------------------T-------E--------------------B-------T---B-------B-----------------------T---------------------B-----B-T--------T-T-------------------
o----B----------B-----T-------------------------------------------------?---------------B-----B---------BE-----B----B---------------T-----BB------------------------T-----------------------E-----------
---EE--------B---------------------B------B---------------------------E---------B---------------------B----------------B-----B------------B----B-----BBE-T-----B----------------T----B------------------
B-----BB---------B-------------B--------------T-----?--B------------------T-----B-----------T-------B--------B---B-EE-------B---------------T-------------------------------------B---B-----------------
-----B-------E---------------------------------------------------------------------------------------------------B----------------T---------------------------------------------EB-B--------------------
---------BT---------B--------------E---|-----E-||-------------------------------------------------------BB---B-----------------E-E----------------B------------------------------T--B-B---B------BE-----
B-----E---|---T------------------------|---------------------B--B---------------------------B-B-----B----E--------------B--------------B---B-----B------T------------------------|----------------------
E---B-----|---|------B--T--------------|-------|---------------------E-------------------------T----------------------E---T-----------------B-----------|-B--B----------------------B------------------v
M---------|---|-B-----B-|-----B--B-----|-B---B-|--------E------------------E-----------E-------|-B----------E-------B-----|-----------------B---------B-|------------------BT------B-B-------|-------B--
-------B-T|-------------|-T---E------E-|------|-|-----?--B-------------------------------------|--B-B-----B-----B-----B---------------T---------B---------B-------------B--------|-B----T----|-E--------
----------|---|---------|----B-------T-|----B-|------B----|---------------------------------------B-----------T-------------------|-------T----------B--------T-----------|-|----------B|-B--|----------
X-------B||-----B-------|-|-E--------|-|------|---|-------|---------------B-B-------|-------------E--|------B-|--------B--|---B---|---|---|---|---------|--------------T--|-|-----------|--------B------
---------||---|----B---B|-|----------|-|------|-|-|----------------------B----------|----B-----|--------------------------|-----B-|---|---|-T-----------|--------------|--|-|----|-B--B-|--B-|-|---B----
---B---B-||-B-|-B-------|-----B---E--|-|-------|--|-----------------B------B--------|-?-------------------B---|-ET--E-B-----------|---|---|-|-|-B-------|--------------|--|------|------|----|-|-------?
m--------||---|---------|----TB----------------||-|-------|---------B------------------------T----------E----B|--|---E---|--------|-------|---|--------B|-----|--------|---------|---B--|------|-B-----?
X-XXXXX-XX-X-X-XXXXXXX-----XX----X-X----X-X-XXXXXXX---XX--X--XXXX-------X--XX----XXXX----XX--X-X-X----X-XXX-XXXX----X-X----X-X-X-X---XX------XXX-X-X-XX--X---------XX----X--X-X--X---XXX-----XXX--XXXXXX
