-------------------------------------------------------------------------------------------------------------------------------------------------------------------------------------------------------X
-----------------------------------------------------------------------------------------------------------------------------------------------------------------------------------------------------E-X
-----------------------------------------------------------------------------------------------------------------------------------------------------------------------------------------------------E--
-------------------------------------------------------------------------------------------------------------------------------------------------------------------------------------------------------X
-------------------------------------------------------------------------------------------------------------------------------------------------------------------------------------------------------M
--------------------------------------------------------------------------------------------------------------------------------------------------------------------------------------------------------
--------B-E--------?B--------E-------------?-------------XX-X---T-------XX--------------------o-oo---E----XXX--B?B-MB?B?------?-------------------XX-----?B--X-----------------oooooX-------------o----X
----------E-------------------XX-------oo-----oooo-oo-----------------------B?------------------E--------M---------------B-B-----?-----E------------------T----------oooo---------------E----XX----?B?-v
--------T----E--E----------M--XXXXXX--E-------B?B-E-------------X---XTE-------------------------XX-X------X-X----------------------X-XX-X----MXX--E--------XXXX--oo-o-?BMB?--XXX-XX-BM--------X--------f
-----E-----XXXX---?B-----------XX-------XX-------X--------------XX--X-----E------T-X------------------------E--X---------------XX--X-X----XTE----XXX-XX-?--X-----T-M-----------X------------X-XXXX-----f
--X-----------BMB?-M-?B------------------------------M-?--------------B-B----------o-------?-?----B?--------------B?B?B?-B-XTEo------T--B-------?B?B--?B?---E--------------------------ooo------------Tf
--E-----------o-o-----XXX---XXXXXX-----------o-oT-o-----X-X-BMB-----T-o---T-------M-----E-XXXX-----------?B-----------XX-X-X|XXXX-XXXXX------------ooo--------------E----XXXXXXXT-X-----------------X-|f
----------?---------?---------TEX----XX---------|--------------XX-XXX--BMB|--X----X--------B?B?B---XX-X-----------XXX-X-----|----o---o-XXB?B?-----X-XX--------E----?BM--|----?--|---------?TEX--------|f
----XX------o-----B?-M--------|------------EE--E|---ooo----X-----X-X|--X-E|------XX---------------XX----------X-------------|-----------------------------------MB--------------|----------|-----T----|f
m-----E----XX----------E-E----|--------B?B------|-----MT-----XXX----|-----|-T-M---E----E---T--E---E-B?--XXX?B?BMo--MB-------|--------|----oooooX---------------------XX--------?|----------|-XXX-|--E-|X
XXXXXXXXXXXXXXXXXXXXXXXXXXXXXXXXXXXXXXXX-X-XXXXXXXXXXXXXXXXXXXX-XXXXXXXXXXXXXXXXXXXXXXXXXXXXXXXXXXXXXXXXXXXXX-XXXXX-XXXX-XXXXXXXXXXXXXXXXXXXXXXXXXXXXXXXXXXXXXXXXXXXXXXXXXXXXXXXXXXXXXXXXXXXXXXXXXXXXXXX
