-------------------------------------------------------------------------------------------------------------------------------------------------------------------------------------------------------T
-----------------------------------------------------------------------------------------------------------------------------------------------------------------------------------------------------XT-
-------------------------------------------------------------------------------------------------------------------------------------------------------------------------------------------------------X
--------------------------------------------------------------------------------------------------------------------------------------------------------------------------------------------------------
-------------------------------------------------------------------------------------------------------------------------------------------------------------------------------------------------------X
-------------------------------------------------------------------------------------------------------------------------------------------------------------------------------------------------------X
----T-----------------------XXX-ooooo-----------------------------X-B?B----X-------------X--E-------------E-----------E----------------X--E----------------------XXX----------------M-------------------
----------------------X---------------------------------------?-?--------------------------------E----------------------B--?---------------------------------------------------------?-?-------B?B?B---v
-------------------------------------X----oT-oooo--------X-X------------------------ooo---------B-BXX----o------BME----------B?B?-?B?B--B---?B?-------------------------XX-X--------------o------------f
--------?------------------EE---X-----E-----XXX-------------T-B-----XT--E---XT-X-E-----E------------XX-oooo-----?-?-ToX--------B-B--------BMB--XXX-----ooooo-B?XXXX--X------ooooXXX---oo----XXX--T--XT-f
---T------------------------------BB--E------X----XXX-------o--B?B-------------?BXX----B--?---------XXX--------------------XXXXXXX--------------o--o------------------XXX-X------B?B?B?B----------X----f
---|---------XT--X---X--------------------------XXXXX--XX--------X-X?B?B-M------XXX--------XX-T-X---X-X?B-B----o-ooX--E-M--------------?B?B--------X---E----T-M----------E------B?-?----X-?--------XXX-f
---|----------|----M-------------------MB---E---B--E-----------------|------------------------|----M----M----------XT--E-------XX----?------B?B-------------|--------------X---------------------------f
--XX----------|-------------------------------------------XXX---ET---|---X--------------------|---E----?B-B--?------|--oE--E----T-X-X--B?B-----------X------|--E----XXX----E---------------------T-----f
m--|-?-?------|----E------------ooo-ooE--------E------X-XXXT-X---|---|----X-----XT------------|--------E|-----------|----ooo---X|-T----?-M----------BMB-B---|----X-X--X-------E--X-------E-------|--E--X
XXXXXXXXXXXXXXXXXXXXXXXXXXXXXXXXXXXXXXXXXXXXXXXXXXXXXXXXXXXXXXXXXXXXXXXXXXXXXXXXXXXXXXXXX-XX--XXX-XXXXXXXXXXXX-XXXXXXXXXXXXXXXXXXXXXXXXXXXXXXXXXXXXXXXXXX-X-XXXXXXXXXXXXXXXXXXXXXXXXXXXXXXXXXXXXXXXXXXXX
