--------------------------------------------------------------------------------------------------------------------------------------------------------------------------------------------------------
--------------------------------------------------------------------------------------------------------------------------------------------------------------------------------------------------------
--------------------------------------------------------------------------------------------------------------------------------------------------------------------------------------------------------
--------------------------------------------------------------------------------------------------------------------------------------------------------------------------------------------------------
--------------------------------------------------------------------------------------------------------------------------------------------------------------------------------------------------------
--------------------------------------------------------------------------------------------------------------------------------------------------------------------------------------------------------
-------------------------------------------------------------------------------------------------------------------------------------------------------------------------------?------------------------
-------------------------------------------------------------------------------------------------------------------------------------------------------------------------------------------T-----------v
------------------------------------------------------------------------------------------------------------------------------------------------------------------------------------?--?---|-------T---f
-------------------------------------------------------------------------------------------------------------------------------------------------------------------------------------------|-------|---f
-------------------------------------------------------------------------------------------------------------------------------------------------------------------------------------------|-------|---f
------------------------------------------------------------------------------------------------------------------------------------------------------------------------------B------------|-------|---f
-------------------------------------------------------------------------------------------------------------------------------------------------------------------------------------------|-------|---f
-------------------------------------------------------------------------------------------------------------------------------------------------------------------------------------------|-X-----|---f
m--------------------------------------------------------------------------------------------------------------------------------------------------------------------------------E-E-------|XX-----|--EX
XXXXXXXXXXXXXXXXXXXXXXXXXXXXXXXXXXXXXXXXXXXXXXXXXXXXXXXXXXXXXXXXXXXXXXXXXXXXXXXXXXXXXXXXXXXXXXXXXXXXXXXXXXXXXXXXXXXXXXXXXXXXXXXXXXXXXXXXXXXXXXXXXXXXXXXXXXXXXXXXXXXXXXXXXXXXXXXXXXXXXXXXXXX|XXXXXXX|X--X
