--------------------------------------------------------------------------------------------------------------------------------------------------------------------------------------------------------
---------?----------------------------------------------------------------B-o---------------------------------------------------------------------------------------------------------------------------
--------B-----------------------------------------------------------------------------------------------------------------------------------------------------------------------------------------------
-----------------------------------------------T---------------------------------------X----------------------------------------------------------------------------------------------------------------
-----------------------------------------------|------------------X--------T----------------------------------------------------------------------------------------------------------------------------
--------?--------------------------------------|-----------------XX--X-----|???----------------------------X--------------------------------------------------------------------------------------------
----------------------------o------------------|----------------XXX--X-----|-------------------------------XX-------------------------------------------------------------------------------------------
-----------------------------------------------|BBBBBB---------XXXX--XXBBBB|----------?--------------------XXX-----------------------------------------------------------------------------------------v
--T----------------------X---------------------|----T---------XXXXX--XXX---|-------------------------------XXXX----------------------------------------------------------------------------------------f
--|--------------------------------------------|----|-X------XXXXXX-XXXXX--|-------------------------------XXXXX---------------------------------------------------------------------------------------f
--|--------------------XXX---------------------|-X--|-XX----XXXXXXX--XXXXX-|-------X-----------------------XXXXXX--------------------------------------------------------------------------------------f
--|--------------------------o-----------------|----|-XXX--XXXXXXXX--XXXXXX|-------XX----------------------XXXXXXX-------------------------------------------------------------------------------------f
--|--------------------------------------------|----|-XXXXXXXXXXXXX--XXXXXX|-------XXX---------------------XXXXXXXX------------------------------------------------------------------------------------f
-B|--------------------------------------------|----|-XXXXXXXXXXXXX--XXXXXX|X------XXXX--------------------XXXXXXXXX-----------------------------------------------------------------------------------f
m-|---------------------XXX--------------------|----|-XXXXXXXXXXXXX--XXXXXX|XX-----XXXXX-------------------XXXXXXXXXX-----------------XXXXXXXX---------------------------------------------------------X
XX|XXXXXXXXXXXXXXXXX----------XXXXXXXXXXXXXXXXX|XXXX|XXXXXXXXXXXXXX--XXXXXX|XXXXXXXXXXXXXXXXXXXXXXXXXXXXXXXXXXXXXXXXXXXXXXXXXXXXXXXXXXXXXXXXXXXXXXXXXXXXXXXXXXXXXXXXXXXXXXXXXXXXXXXXXXXXXXXXXXXXXXXXXXXX
