-----------------------MB------o-------------X---B---------------------------------X-B----B-------o-------------?----------------oX?-B-B--------------B-----M-?-M---------------MB------------?---------
-----o----X----------------------o-------------------------------------o--------------------?-----X-X-----------------------XX---o-----?---oE---E-B--X-E--------------------?--?B-----------------------
--------E-----------------------------o----?--------------------------------------X--------------?-------X------------E--o------T---------E-X--B---o-------------------------M---Xo----B----------X----X
-------------X----------------XT--BE-M-------B----o------------------B-------------M------------------------o---------T-?------o-----------?------------------------?--------B-------------B---B---M----
-----o------X----------XX-X------X-B-B---X--------XB------------?------B------E-------------X------M---------o----------------------------E-------o-----?-----------------------o---M--E-----B----X-----
-------?--------o-------MB-M---E------------------B---------B-------o-------------------o------?--?--------------X-------|-E--X------X-------------?----------T----B-----E-------E-----B----MB----------
-------B----------------X-------------o-----------X------------X--M---------X------------X-------------M-B----------o----X------------?---Eo--o-----M---------------B---------------|----------X--|----?
-------B--X-----E--E------------o---------XX----------B---------------------o-|--B-XXX-M------------------E---------------------B--B-------X-----B-X-------|--|---------B-X----E-----------------------v
--------------------B---------B--------------B-------X-T---E--X-M-----------B--------------X---M-------?-----------------|-|----------|XX|------------------?--------M--------------o----B----E---|--B--
------EB------------X---------X---------X---B-------X--|--------------M--?-----o---------o------?---X---------M---X---?----X-XE-------|---------M--?-|-----|----M--E------M------B--|---------o----X----
------------oo-----E--?----------------o|----------XE------B-----------------------T-B--------|-B-------M-----o--|---------|----T----------------EB--|-----|----------------------o-|---B---o-----|-----
--B-------o--------------X-E----------X-|--X-------Xo--|-------------E-------------|---B------|------------o-?--B------X-|---X--------|--------------|--------|-----?---------------------o-------|-----
----------------------------------------|------------T-|---o-B---------------------|---M------|------o-----B--B-----o----|----B-|---M-|--------------|-----|-----------------B-XB------o----------|--B--
-----E--X--B-X--------------------------|---------B--|-|-B-E----------E------------|-B-----E--|-----------B--B-B---B-----|-|-----------o-----------------o-|-o|----------------X-------------X---B-----o
---o---Xo---------B---------------------|---B--------|-|---E-E------------BB-M-----|----------|-?---------o-B------------|-|---X---------|--o--o-----|----E|-------------------E--o---------E-T-----B--o
--XXXXXXXXXX-XXXXXXXXXXXXXXXXXXXXXXXXXXXXXXXXXXXXXXXXXXXXXXXXXXXXXXXXXXXXXXXXXXXXXXXXXXXXXXXXXXXXXXXXXXXXXXXXXXXXXXXXXXXXXXXXXXXXXXXXX-XXXXXXXXXXXX-XXXXXXXXXXXXXXXXXXXXXXXXXXXXXXXXXXXXXXXXXXXXXXXXXXXX
