-------------------------------------------------------------------------------------------------------------------------------------------------------------------------------------------------------B
--------------------------------------------------------------------------------------------------------------------------------------------------------------------------------------------------------
--------------------------------------------------------------------------------------------------------------------------------------------------------------------------------------------------------
--------------------------------------------------------------------------------------------------------------------------------------------------------------------------------------------------------
--------------------------------------------------------------------------------------------------------------------------------------------------------------------------------------------------------
-------------------------------------------------------------------------------------------------------------------------------------------------------------------------------------------------------X
--T------------------------------------------------------E----------------T-X------------E-XXX----------T--------------?B------------------------E---X-----------XXXX---------------E-------------------
----------------------------------------------MBMB?---X--X-XXXX-------------E-XT-X---------o-ooo------------E-----------------------------------?-MB-XX----E-------------------------------------------v
-----------------------------------------XX----------------X---X---M------------E---M---X-X----------B?B-----------E------E--------------------------------E---B?B-----------oooo-------EB---?B?-?B----f
--X------------?----------oooX-----------?B?B?----------E------------------------------------X---X?B?--------o--------------------ooo-----------oooT-----------T--XT-----------T-X---T--XEXX--X----XX--f
----?--------XXX----X--XXX--XX--------E--------------------------E?-M---------XX----E---BMB--------------E-------------------?B?-----oT------X--BMB-------------------T-o----XXX------XXX?B----o----XX-f
-------o-ooooooooXXXX-X---XXX-------------------XX-----E--------------------M--E------------------------X----------------X------X-----|--XXXX---|----?-?--------X-----|----XX---o---------XT-----T-----f
----oo----E--E--------------------------o------------X--X----X-XXXX-X--XXT-|----------BT---oo-----------XX------MB?B?B---E-------X---X|---E-----|----X--X-X------?B---|--X---------------T-|-----|---X-f
----E---------------E---B?B?----E-X--X-----X-?-E--XX--X-X------?-XT-M----|-|-E-X------X|----T-M----B?------?-------EXXX------------M-M|---------|-XXXX---X|XX---------|-----------X------|-|---M-|-----f
mXT-M--------------X-----------------------------E--------E-------|--o---|-|-E-|-ooo?--|----|---------------?B?B---XX----XXX----------|---------|-----XXX-|------B-B--|-XX---X-XXXX-X-X--|-|-----|-----X
XXXXXXXXXXXXXXXXXXXXXXXXXXXXXXXXXX---XXXXXXXXXXXXXXXXXXXXXXXXXXXXXXXXXXXXXXXXXXXXXXXXXXXXXXXXXXXXXXXXXXXXXXXXX-XXXXXXXXXXXXXXXXXXXXXXXXXXXXXXXXXXXXXXXXXXXXXXXXXXXXXXXXXXXXXXXXXXXXXXXXXXXXXXXXXXXXXXXXX
