-------------------------------------------------------------------------------------------------------------------------------------------------------------------------------------------------------T
-----------------------------------------------------------------------------------------------------------------------------------------------------------------------------------------------------XT-
-------------------------------------------------------------------------------------------------------------------------------------------------------------------------------------------------------X
--------------------------------------------------------------------------------------------------------------------------------------------------------------------------------------------------------
-------------------------------------------------------------------------------------------------------------------------------------------------------------------------------------------------------X
-------------------------------------------------------------------------------------------------------------------------------------------------------------------------------------------------------X
----T-----------------------XXX-ooooo-----------------------------X?B?B----X-------------X--E-------------E-----------E----------------X--E-----------------------X-----------------?-------------------
----------------------X---------------------------------------?-M--------------------------------E----------------------B--?---------------------------------------------------------?-?B------B?-?B?--v
-------------------------------------X----oT-oooo--------X-X------------------------ooo---------B-BXX----o------BME----------B?B?-?B?B--B---?B?-------------------------XX-X--------------o------------f
--------?------------------EE---XX----E-----XXX-------------T-B-----XT--E---XT-X-E-----E-------------XX--o------?-?-T-X--------B-B--------BMB--XXX-----ooooo-B?X-XX--X------ooooXXX---oo----XXX--T--XT-f
---T----------------------------B-BB--E------X----XXX-------o--B?B-------------?XXX----B-----------XXXX--------------------XXXXXXX--------------o--o------------------XXX-X-------?B?B?B----------X----f
---|---------XT--X---X--------------------------XXXXX--XX--------X-X?B?B-M------XXXX-------XX-T-X---X-X?B?B---oooooX--E-M--------------?B?B--------X---E----T-M----------E------B?B?------?---------X--f
---|----------|--M-M-------------------MB---E---B--E-----------------|------------------------|----?----M----------XT--E-------XX----?------B?B-------------|--------------X---------------------------f
--XX----------|------------------------------------------XXXX---ET---|---X--------------------|---E----?B-B--?------|--oE--E----T-X-X--B?B-----------X------|--E----XX-----E---------------------T-----f
m--|-?-M------|----E------------ooooooE--------E------XXXXXT-X---|---|----X-----XT------------|--------E|-----------|----ooo---X|-T----?-M----------B?B?B?--|----XXXX-X-------E--X-------E-------|--E--X
XXXXXXXXXXXXXXXXXXXXXXXXXXXXXXXXXXXXXXXXXXXXXXXXXXXXXXXXXXXXXXXXXXXXXXXXXXXXXXXXXXXXXXXXX-XX--XXX-XXXXXXXXXXXX-XXXXXXXXXXXXXXXXXXXXXXXXXXXXXXXXXXXXXXXXXX-X-XXXXXXXXXXX-XXXXXXXXXXXXXXXXXXXXXXXXXXXXXXXX
