----------------------E---------------------------------------------B------------------------------------------------------------B-------------------------------EB--------B----B-------------------B--X
-------BE--------------X----------------------------------------------B--------E-----B----E---------------------------------------?-------------------------------------------------E------------------E
E---------------------------------------------------------B----------B--------------?-------------------B-------?------------------T-BE--------E---------E---------MT------B--------B-------------E-----
B-------------------------B------------T--------------------B------X----------------B------------------B-----------------B--------M|--------------------------------|----T----T------------------------M
-E----E---------------------E----B-----|-T---------------------B--B------B-----------X------------------------------------E--------|-E---------E------E-------------|----|----|--------EB---B--B-------X
-----E-------------B-------B-----------|-|--T------------B-------------T----------------E------------E-----?-----------------------|-E-----------------|------------|-?--|----|-----E-----------B----E--
--------B------------------------------|-|--|-------------------------||-B-------------B-E-------------------------BB-T------------|---------------B--------------E-|----------------------BE-----------
----------------------------B---EE-------|--|------B--M--B------------|-T--------------------T----------B------T------|-----------E---------M----------------B--T---|-------------------EB-------------v
--------E-B-T---B--------o-E----------------|--E---E------B-------E---|-|---------------E----|----------------||--------B--T-------|-E--------------------------------------------EE----------------B--o
------------|-------T-----------------?-----|---------E-------B---------|-----------|--------|----------------B|-----------|-----------------|-----------------------B------------------B---B-----------
------------|-------|----------------E------|---------------B-E-------|-|--E--E--------------|--T-----------------E--------|--------------------E-E-B----E--------|-----------------B-------------------
B-----T-B-B--|--------E-----E------------|-B|-------------?--T----------|--------------------|--|-----|-----------B--------|-------------B--------B-------M-B----------------------------------------T-B
------|------|--T--E--ET----------B------|--|--------B-B-B---|-----B---B|--T-------------X-----B|---------------------B----|------?-----E---------------E---------|--|-----------------------E-------|-?
X------------|--|------|--------B-----------|--E-----B----|--|----------|--|--B----------------E----B-|--T----E------------|-----------------|---------------T---------------------------------------|--
m--------E---||-|---------------------------|----------------|----------|--|--------|-------------B---||-------------------|-----------------|----EE---------|--E-|-------------------------------B--|-X
XXXXXXXXXX-XXXX-XXXXXXX-X-X-XXX---X-----XX-XX--X-X---XXXX-X-XX-XXX--XX-XXX-XX-X---XX--XX--XX-X-X--X-X--X--X-X-X----X----X--X-X--XX-X-XX-X-X-----XX--X-X--X-X-X--XXXX--XX-X-X--X-X-XX-?XX-X-X-X--X-XXXXXX
