--------------------------------------------------------------------------o-----------------------------------------------------------------------------------------------------------------------------
--------------------------------------------------------------------------------------------------------------------------------------------------------------------------------------------------------
--------------------------------------------------------------------------------------------------------------------------------------------------------------------------------------------------------
--------------------------------------------------------------------------------------------------------------------------------------------------------------------------------------------------------
-------------------------------------------------------------------------------?------------------------------------------------------------------------------------------------------------------------
--------------------------------------------------------------------------------------------------------------------------------------------------------------------------------------------------------
--------------------------------------------------------------------------------------------------------------------------------------------------------------------------------------------------------
----------------------------------------------------------------?--------------------------------------------------------------------------------------------------------------------------------------v
-------------------------------------------------------------B----B------------------------------------------------------------------------------------------------------------------------------------f
---------------------------------------------------------------?----M----------------------------------------------------------------------------------------------------------------------------------f
-------------------------------------------------------------------------------------------------------------------------------------------------------------------------------------------------------f
--------------------------------------------------------T---------T------------------------------------------------------------------------------------------------------------------------------------f
--------------------------------------------------------|-------X-|------------------------------------------------------------------------------------------------------------------------------------f
--------------------------------------------------------|------XXX|---X------------------------------------------------------------------------------------------------------------------------------o-f
m-------------------------------------------------------|--E-EXXXX|--XX---E----------------------------------------------------------------------------------------------------------------------------X
XXXXXXXXXXXXXXXXXXXXXXXXXXXXXXXXXXXXXXXXXXXXXXXXXXXXXXX-|-XXXXXXXX|XXXX--B--XXXXXXXXXXXXXXXXXXXXXXXXXXXXXXXXXXXXXXXXXXXXXXXXXXXXXXXXXXXXXXXXXXXXXXXXXXXXXXXXXXXXXXXXXXXXXXXXXXXXXXXXXXXXXXXXXXXXXXXXXXXX
