--------------------------------------------------------------------------------------------------------------------------------------------------------------------------------------------------------
-------------------------------------------------------------------------------------------------------------------------------------------------------------------------------------------------------X
-------------------------------------------------------------------------------------------------------------------------------------------------------------------------------------------------------X
-------------------------------------------------------------------------------------------------------------------------------------------------------------------------------------------------------X
-------------------------------------------------------------------------------------------------------------------------------------------------------------------------------------------------------X
-------------------------------------------------------------------------------------------------------------------------------------------------------------------------------------------------------o
---------------------------E------E-----------------------------E---------------------------------------------------?B?BMB------------------E------------------------------------------------X----------
--------------------------------E-------------------B?B---E------------------------------------------------------------------------------?-?B--M-E----------------------------------------T------------v
---------------XXX-------o---oo------XXX--------X---------------E--M------X--X----M----T---------------BT-X---X?-MB-----XXXX-B?--------E---------------?--B-E-------X-Xooo-E-----E--B?B?----E--E--X-XX-f
---------------E---ooo-X----B?B-----------------?------XXX---XX--------o-ooo--------E-------oT---XXXX--------B?BXXXXXT---------XT----T-XXX-----ooo----XE----------E----XXX-o-o--E--?T--XX----X-X-------f
--T-X----XT------E------X----------------------------E--------XE-B----------X----------E-?B?BM-XX-------------B?B--M-?TEB-XXXX--XXX--XXX----ooooo------MMT-X---------B?B--------B?B------TT-XXX-XX-X-T-f
--|--?T-B-|--------------E---E--E-------X---------XXX---E-----------XXXX--E------XXX-XX------oo-----------------E-----|--X---E------X---------X---E---XT-|------?BXXX-------------XT-X---||----------|-f
----?-|---|--E----------------------------------|---------B-B?B-?B-----E------XXX---XX--M---------XX----------------X-|-T-E--?-MB?-M----------o--------|-|---B--M------X---XXX--|--|-----||--M-----o---f
------|--------------E-----B-------------E------|-?--BM-Xooo---o---o--------------------------------------------------|-|------------------------------|-X------------B|?BXX-XXX|--|---E-||----------|-f
m-|---|-----?------o-o-------o------------------|-------------------E------E-----E--------E--ooo------?B?-BMB?BMB-----|-|------X-----------------X-----|-|-XXXX--------|--XX-X--|--|-X-XX-|--o-------|-X
XXXXXXXXXXXXXXXXXXXXXXXXXXXXXXXXXXXXXXXXXXXXXX-XXXXXXXXXXXXXXX-X-XXXXXXXXXXXXXXXXXXXXXXXXXXXXXXXXXXXXXXXXXXXXXX-XXXXXXXXXXXXXXXXXXXXX-XXXXXXXXXXXXXXXXXXXXXXXXXXXXXXXXXXXXXXXXXXXXXXXXXX-XXXXXXX-XXXXXXX
