-----------------------MB------o-------------X---B-------------------------M-------X-B----B-------oM------------?----------------oX?-B-B--------------B-----M-T-M---------------MB------------?---------
-----o----X-------------X--------o--------X----------------------------o--------------------?-------XX---------------------?X-XX-o---------oE---E-B--X-E--------------------?--MB-----------------------
--------E---------------X-------------o----?---------------------------------------------X-------?-------X------------E--o------T---------E----B---o-------------------------?---Xo----B----------X----X
-------------X-----------------T--BE-M-------B----o------------------B-------------M------------------------o---------T--------o-----------?X-----------?-----------?--------B-------------B--MB--------
-----o------X----------X--o------X-B-B---X--------XB------------M------B------E--------X---------------------o-----------T-X--------------E-------o-----M--------------------o------M--E-----B----X-----
-------?--------o-------MBXEM--E------------------X---------B-------o-------------------o------?--?--------------X-------|-E--X------X-------------?----------T----B-----E-------E-----B----MB----------
-------B----------------X--------------o-----------------------X--M---------X--------X-----------------M-B----------o-----------------?---Eo------------------?-----B---------------|----------X--|----?
-------B--X-----E--E------------o----------X--------XXB---------------------o-|--B-XXX-M------------X-----E---------------------B--B----------X--B-X?------|--|---------B---X--E-----------------------v
--------------------B---------B--------------B---------T---E--X-M-----------B--------------X---??------?-----------------|-|----------|XX|------M-----------?--------?--------------o----B----E---|X-B--
------EB------------X---------X--o------X---B-------B--|---------M-------------o-X-------o--------------------?---X---?------XE------X|--------------|-----|----?--E------M------B--|----o--------------
------------oo-----E-------------------o|----------XE------B-------------M---------T-B--------|-B-------M---o----|---------|----T----------------EB--|-----|----------------------o-|---B---o-----|-----
--B-------o-----------?--X-E------------|--X------oX---|-X-----------E-------------|---B------|------------o-?--B------X-|---X--------|------------?-|--------|-----?---------------------o-------|-----
--------------------------------------X-|------------T-|---o-B---------------------|--------M-|------o-----B--B-----o----|----B-|---M-|--------------|-----|-----------------B-XB------o----------|--B--
-----E--X--B-X--------------------------|---------B--|-|-B-E----------E------------|-B-----E--|-----------B--B-B---B-----|-|-----------o-----------------o-|-o|------------------------------X---B-----o
---o---Xo---------B---------------------|---B--------|-|---E-E------------BB------M|----------|-?---------o-B------------|-|----------X--|--o--o-----|----E|----------------------o---------E-T-----B--o
--XXXXXXXXXX-XXXXXXXXXXXXXXXXXXXXXXXXXXXXXXXXXXXXXXXXXXXXXXXXXXXXXXXXXXXXXXXXXXXXXXXXXXXXXXXXXXXXXXXXXXXXXXXXXXXXXXXXXXXXXXXXXXXXXXXXX-XXXXXX-XXXXX-XXXXXXXXXXXXXXXXXXXXXXXXXXX-XXXXXXXXXXXXXXXXXXXXXXXX
