-----------------------------------------------------------------------------------------------------------------------------------------------------------------------------------------------------T--
--------------------------------------------------------------------------------------------------------------------------------------------------------------------------------------------------------
--------------------------------------------------------------------------------------------------------------------------------------------------------------------------------------------------------
-------------------------------------------------------------------------------------------------------------------------------------------------------------------------------------------------------X
--------------------------------------------------------------------------------------------------------------------------------------------------------------------------------------------------------
-------------------------------------------------------------------------------------------------------------------------------------------------------------------------------------------------------?
---E--------------EE---------------B------E---------------?-?----------X-X---XXXXX----T----------E-Mooo-XXX-?B-XX-X--XXX----------------------------T-X---M-M--XXX----XT-X-XXXXX---XX--------X-XXX----EX
------------------------------?-----------------------------X-XXX------------------------T----------MB?--B--X-X--------EXXX-X-------------?---B?B?B?BXX------o---XX-----X--X?-?B?XXX--oooT-----X-X-----v
--E------------XX---------------------------------------XXXX-------XXX----------M-E--E-E--------o-o--------MB-B--X-X------------------E-------------E---XXX--------T-------?TE-E--------MB--X---X----E-f
------B--MB-------X-X---?--TE---B?-------------T-X----------o-o-----XX-X--X---E-B-B?B?-----------------E----T----E-?---------E--------B?---------T-o---?oo-o----XXXX-MB--------XX-X--------M--B----X--Xf
------------X---------E-----X--------X-------MT-X-------oT-XX-------MBoo-------T--?---X----------?-X----ooo------M---X--M---o--------?E---X--T---XX----------M--XX----E-T-----M----X--XXXXXXX--X--oXXX-f
-------|--------------------------------------|---E------XXXXX-----E---XXX-----|-------------TTXX----?B?M-----?B?B-----?B?---?-----------X---X----XXTEX------o----------|--ooo------T-B-----X-XX?B?E---f
----X--|--------------XXX----T-oooo-B---------|----------XX-----E----|B----------------ooooo-||-----?B?BM-------------------ooo---------EXXXX|-----E|-?-E-------B---BMB-|-----------|--B-------?B?B?B--f
-------|------X--X-----------|-------XT------?-------T---|------B--?-|--E------|-------------||-----------------X-----------XX-------------?-|XXXXT-|---X--------------E|----------T|--T-XXXX-------M--f
m------|--------------E------|--------|--------------|---|-----------|---------|----BMB-XTT--||--oo--oooo------XXXXXXXX-----XXX-----------o--|----|-|------------------XXX---------||--|--T--T----X----X
XXXXXXXXXXXXXXXXXXXXXXXXXXX-XXXXXXXXXXXXXXXXXXXXXXXXXXXXXXXXXXXXXXXXXXXXXXXXXXXX-X-XX-XXXXXXXXXXXXXXXXXXXXXXXXXXXXXXXXXXXXXXXXXXXXXXXXXXXXXXXXXXXXXXXXXXXXXXXX-XXXXXXXXXXXXXXXXXXXXXXXXXXXXXXXXXXXXXXXXX
