-------------------------------------------------------------------------------------------------------------------------------------------------------------------------------------------------------X
-----------------------------------------------------------------------------------------------------------------------------------------------------------------------------------------------------E-X
-----------------------------------------------------------------------------------------------------------------------------------------------------------------------------------------------------E--
-------------------------------------------------------------------------------------------------------------------------------------------------------------------------------------------------------X
-------------------------------------------------------------------------------------------------------------------------------------------------------------------------------------------------------M
--------------------------------------------------------------------------------------------------------------------------------------------------------------------------------------------------------
--------B-E--------?-M-------E-------------?-------------XX-X---T------XXX-------------------ooooo---E----X-X--B?B-MB?B?------?-------------------XXX-----B--X------------------oooo--------------o----X
----------E-------------------XX-------oo------ooo-oo-----------------------BM------------------E--------M---------------B?B-----?-----E------------------T----------oooo---------------E----XX----?B?-v
--------T----E--E----------M--XXXXXX--E--------?--E-------------X---XTE-----------------------X-XX-XXX----X-X----------------------X-XXXX----MXX--E---------X-X--oo-o-MB?B?--XXX-XX-BMB-------X--------f
-----E-----XXXX---?B-----------XXX------XX-------X---------------X--X-----E------T-X------------------------E-------------------X--X-X----XTE----X-X-XXX?--X-----T-M-----------X------------X-XXXX-----f
--X------------M-?-M-?B------------------------------M-?--------------B-B---------ooo------?-?--o-B?--------------B?B?B--B-XTEo------T--B-------?B?B-B?B?---E--------------------------oooo-----------Tf
--E-----------ooo------XX----XXXXX-----------o-oT-o-----X-X-BMB-----T-o---T-------M-----E-XXXX-----------?B-----------XX-X-X|XXXX-XXXXX------------ooo--------------E----XXXX-XXT-X-----------------X-|f
----------?---------?---------TEX-----X---------|----------o---XXX-X|--BMB|--X----X--------B?B-B---XXXX------------XX-X-----|---oo---o-X-B?B?-----X-XX--------E----?B?--|----?--|---------?TEX--------|f
----XXX-----o-----B?-M--------|------------EE--E|---ooo----X-----X-X|--X-E|------XX--------------XXX----------X-------------|-----------------------------------MB--------------|----------|-----T----|f
m-----E----XX----------E-E----|--------B?B-B----|-----MT-----XX-----|-----|-T-M---E----E---T--E---E-B?---X-?B?BMo--MB-------|--------|----oooooX---------------------XX--------?|----------|--X--|--E-|X
XXXXXXXXXXXXXXXXXXXXXXXXXXXXXXXXXXXXXXXX-X-XXXXXXXXXXXXXXXXXXXX-XXXXXXXXXXXXXXXXXXXXXXXXXXXXXXXXXXXXXXXXXXXXX-XXXXXXXXXX-XXXXXXXXXXXXXXXXXXXXXXXXXXXXXXXXXXXXXXXXXXXXXXXXXXXXXXXXXXXXXXXXXXXXXXXXXXXXXXX
