----------------------------------T----------------------------------------------------------------------------------------------------------------------------------B----------------B--------------B--
--------------------ET------------T---E--E------------------------------------------T--T------------BB-B-----------T-----------B-M---B----------B------------------------------------------E------------
E--------------------------B------------------------------T-----------------T-B-T---------------T-------------E------------------------E-----E----M-----------------------------T-------B-------------B-
o---B------------------E-------------------------------B---------E-----------------------------------------------E-----------------------B-B-E-------------------------------T-------------T-----B------
----------B--------------------------------------B----------------------B-------------B------------------------B---------------------B-----E----E----------------E------B----------------------------B--
M--T-------------------------------------B-----------------------T----------B--------B------------------------------------------------------------B---------------B-------------------------------------
---B-E---------------B-------------------------E-------------------T-------------T----------------------------------------------------------------------B----B--------E---------------------------------
o-------T-----B-----B-T-----B----------------------------------X-----B-E------------------------B----------------E------------------------------------B---------------------------------------------E--v
----------------------E----B-------E----T------------E---------------------E------------------------------------------------------B--------E-----B------------------------------------------B-----------
---E-------------------B----------------|---------------B---------------B---B------------------------E---E-------------------------------B------------------------E------------TB--------------------|--
o-----------------------------B-----|---|------B---B---E-B------------B-----E-----------------B------------T------------B----------------------------------------------------o----------B------------|--
-------------------|-----------------------B----------------------------------------------------------------------------------E--------------------------------T-------B---E-E-|-----------------|---|--
----------------------B|------------|---|-B----B----|-------------------------------E--B-E-------B----T----------------B----E-----------B-B-------B--------------------E-------|-----------------|--B|--
---------B---E---------|----------------|-----B-----------B---------------------------------T------?----------BBB------B-----T------------------------------------T------------|----EB-B---------|---|--
m--------------|---|---|-----B----------|-----------------E-T-----------B----------------B---------------------E-------------|--------------------B------------|-----------E---|-------T---------|---|--
X-XXXXXX----XX---XX--X-----X-X---------XX---XX--XXX-XXXX---XX-------XX---XX---X---XX-XX-X--XX----XX--X--X--X-XX--XXXXX---XX-------XX-XXX-X-----X-XXX-XXX-X--XX--XX-XXX-X-X-XXXXX-X-----XX---X--X--XXXXXX
