-------------------------------------------------------------------------------------------------------------------------------------------------------------------------------------------------------E
-------------------------------------------------------------------------------------------------------------------------------------------------------------------------------------------------------X
--------------------------------------------------------------------------------------------------------------------------------------------------------------------------------------------------------
-------------------------------------------------------------------------------------------------------------------------------------------------------------------------------------------------------B
--------------------------------------------------------------------------------------------------------------------------------------------------------------------------------------------------------
--------------------------------------------------------------------------------------------------------------------------------------------------------------------------------------------------------
---E------------XT-XX--------E-----o---B?--------------T-B?B?-------BT-o----------X--M----------E-----o-o-----X-XT-o------X--------E--oo-X--XXX-TEXo-----X??-ooo-----?-X-X--?BM--B?B--XXXX-----XX--E----
----------M------B-------BMB-----------------------------?-X----------oT-o--------------?----------E--E----oT-B-E----------oo--ooooo---X--?B?B-----------------?X-------------BT-X--------o------------v
------XXXX-XX-------------------Eoo-----MB----ooo-------------------o---------T-X---------E------XXXX-B?B------oo--------XX-----oo-o-----T--------------o--------------?B-BT----oE---X-T-XX?B?BEEX---MTf
----------------------------E----E--------------?B?B-X-----------MT-------------T-X--X---o-XB?--?B-----------------------------?-XXX-----------------M---------X-----ooo-----X-X-X--------EM--BXXXX----f
------------------------?B?B-----XX---X--X-X-X-----------------------XT-XE----ET-T-o-o-?B----------o-o--o-T-XXX---------E-XXX--XXX--X--B-B-oT-o--?--?B?XXXXXXX-XXo--X---XX--B-B-M------XXXX-------BX---f
--------------------------------MB----XXX---------------ET-X-----------------E-|-|--E------X-------|--?------------EE-----oTEX--------------|--------------------T---X--XXXX--?-?---BMBX------o--X-X-T-f
--E------XX--X---------------------o--oo-----?E----------|----?-------|------E-|-|---------X---------------------o---E-oo--|---------------X----------ooo-?-?B---|-o------M-M------EE---|----X--XT-B-|-f
--X-XXXX-X--?B-X---X-------------T--------XXXXX---?B?BM--|------------|--oooo--|-|--E------------|-|------|-------XX-------|---T-oooooo---X---------E-X------o---|------------------XX--|---B----|---|-f
m----?---------------------------|---B?-X-XX-------------|--------XXX-|-|------|-|---------------|-|-B?--------T-----------|---|--X---X----E|-T-X--------B-BT----|-------B?-?-?-X---|--?B?B?XXXXX|-XX|-X
XXXXXXXXXXXXXXXXXXXXXXXXXXXXXXXXXXXXXX-XXXXX-XXXXXXXXXXXXXXXXXXXXXXXXXXXXXXXXXXXXXXXXXX-XXXXXXX-XXXXXXXXXXXXXXXXXXXXXXXXXXXXXXXXXXXXXXXXXXXXXXXXXXXXXXXXXXXXXXXXXXXXXXX-XXXXXXXXXXXXXXXXXXXXXXXXXXXXXXXX
