?-----------B--B-------B----B--------------------------------------------?----------B---B-------------B---------B-E-------T--B------------------------------------------------------------B-------------
o---------B---------------B---------B-B----------------BE-E--------B----------------E----E--T----------B----------B----------T-----------T-----T-----------------------------B-----------B-----------B--
E----------------------------------------E----B------B----------B----------------E-----TBB-----------------------------------------------B------B--------T--B----------T------------------T----------B--
?--B-------------------------B-B--B-----------B----------------B------B--------------------------------------------T----------------B---B-------------TE---------B-------B-----------------B---------BB-
----------------------------------T-------B-B----B------B---------------------B-T--------T-----------------------------------B-------B-------B-M-B----B---------T----------T---------------B------------
-----BE----------------B---BB-------------------B----B--------BB--T---------------T-E---E-------B----------B-----------------------E-------------------------B------------||---T------------------------
-------------E-------------T------|--------------------E--------------------------|------|---------------------T---------------E------------------E-----------|-----------||-B-|----E--TB------------EB-
------------B---------B-------BB-----------B-|---T------------B--B------------B-------------?------------------------------XB------B-----------------TE-------|-|----------|---|-----------------------v
B-------------B------------|------|--------------|--B-----------B-------------------E-|--|----B----BB----|-----|--------------------------E-------------------------E----------|--|---------------------
?------------B-------B-----|--------------B--------B---BT---------------B-----B-------|-------------T-B-B------|--------------------B-------|------E------------|-------|-|----|------------------------
?---T-----|-------------------------------B--|---|-----T|---------|-------E--T--|-|------|------------B-B------|---------------------T------------------------|-|----B--|-|-------------------B---------
----|---E----E------T------|---------------B--------T-E-|--------------------|--|-|---|----E--B--|--|-E--|-----|-------E---B---B--B---------|------------B--E-|-|---B-----||---|--|--------------B------
B---|--E--|---------|-BB---|---B--|------E-----B-|-E|--|---------T|----T-----|--|-|------------E-|--|----|-T-B-------------------T---|------|--B--BB------|-----|-------|-||-T-|--|--B-|-|-|--B-------B-
----------|--B---------B--o---B-------|---B-B----|--|--||-T----E-|----||---B-|--|-|--B---|-------|----B-B--|------B--------------|---------------B---|----|---|-|---E---|-|----|--|-E--|---|------------
m------------B------|--E---|-----------|-----|--B|-B|--||--------||---||-T---|--|-|---|--|---B-BB|--|-BTB--|--B---E-B---|--------|-----B-------------|----|---|-|-B-----|-||-|-|-B|--B---------------B--
X-XXXXXX------XX---X----X-X---XX-XX--XX-XXX----XX------XXX--XX----XXXX-XXX--X-XX--X-X--X-X----X-X--XX-XX---X--XX-X---X-XX-------XX--X-X-XX---X--X----XX---X--X--------XX---X-X-X-X-XX-XX-X-XX---X-XXXXXX
