-------T-----------------------------B-----------------------------------X-----------X--------M----------------?-------------------------B-----------------------------------T---------B--------------B-
-------T------B-------------------------------------------------B--------------------------E-----------------------------------E----------------------------------E-------------T----------------------M
------------------------E--------------------------E----T-----------------B---B------B--------------------------------E------B----------------------------------------------------------B--B------------
-----------------------B--------------------------------------------------------B-------------------------------------------------E-------B--------------------------------------E---B-E---------------?
-----B----------B-----------------B---------------B-----------------------------------M-------------------------B--B--------------T----------B----BB-------------------------------------------------B-?
-----------------------------------------------------------------------------------B----------------E-----------------------------|----B----------------X-------E---X----------------B----------------BB
-------B--BB-------B---------------B--------T-----------------B------------E|--------------B--B---|-------------------------------|---------------------------------------------------E-----------------
----?---------------|-------|----------------------BE-----------------------------------------------B--------E--------------------|---------------------------B------------------------E---------------v
------BE--------------------------B-----------------M-----------------B----B|-B-|-----------------------------------X-------------|---------B-------BB-----------------------------------------B-------B
------B------|------|------B--------------B-|--?--------------------------------|-----------E-----|--BE--------------T----B-------|--------B---------B--B---------T------E----B---------B--------------B
-------------|---------E--------E----B------|--------|-----|----------------|--T|----E---T------------------------T--|-----E------------------------B----------------B---E-------------T----T-------E---
-------------|----|-|---------------------?T|----------B---|---BB-------T-E-|--||--------|--------|------------------|--------------B----------E--------B---E--------------------------|---------------X
------|------|----|-|-------|--------------||-|------|--B--------------------------B---|-|--------|---------------|--|----T--------------BE--T---------T----------|-----T--------------|-------T-----BB-
-----B|------|----|-|------------------|--B----------|---B---------E--------|----------------B------------B-------|--|-B------------E--------|--------------------|-----|-------E------|---T---|--------
m-----|------|----|-|-------|------B---|----|--------|--T--|----T-----B-----|---|----------B----------B------E-------|-TB-|-E-----|----------|---------------B-------------------------|---|---|-------o
X-XXXXX-XX-X-X--X-X--XXX-XX-------XX-XX----XX-X-XX---XXX--XXXXX--XX--X--XXX-XX---XX----X-X-XXX-----XX-------XXXXXX--XX--XX---XXX--XXXX--X-X--X-XX--X----XX-X--XXX---X--XX----XX---X------X--XXXXXXXXXXXX
