-----------------------MB------o-------------X---B---------------------------------X-B----B-------o-------------?----------------oXM-B-B--------------B-----M-T-M-----------?---MB------------?---------
-----o---------------------------o-------------------------------------o--------------------?-X------X----------------------XX---o-----?---oE---E-B--X-E-----------------------MB-----------------------
--------E---------------X-------------o----?--------------------------------------X--------------?-------X------------E--o------T---------E-X--B---o-------------------------M---Xo----B----------X----X
-------------X-----------------T--BE-M-------B----o------------------B-------------M------------------------o---------T-?------o-----------?------------?-----------?--------B-------------B---B---M----
-----o------X----------XX-X------X-B-B---X--------XB------------?------B------E-------------X------M---------o-----------X----------------E-------o--------M--------------------o---M--E-----B----X-----
-------?--------o-------MB-M---E------------------B---------B-------o-------------------o------?--?--------------X-------|-E--X------X-------------?----------T----B-----E-------E-----B----MB----------
-------B----------------X-------------o-----------X-X----------X--M---------X------------X-------------M-B----------o-----------------?---Eo--o-----M---------?-----B---------------|----------X--|----?
-------B--X-----E--E------------o---------XX----------B---------------------o-|--B-XXX-M------------------E---------------------B--B-------X-----B-X-------|--|---------B-X----E-----------------------v
--------------------B---------B--------------B-------X-T---E--X-M-----------B-----------M--X-----------?-----------------|-|----------|XX|------------------?--------M--------------o----B----E---|X-B--
------EB------------X---------X---------X---B-------B--|--------------M--M-----o---------o------M---X---------M---X---?----X-XE------X|---------?--?-|-----|----M--E------M------B--|---------o---------
------------oo-----E-------------------o|----------XE------B-----------------------T-B--------|-B-------M---o----|---------|----T----------------EB--|-----|----------------------o-|---B---o-----|-----
--B-------o-----------?--X-E----------X-|--X-------Xo--|-------------E-------------|---B------|------------o-?--B------X-|---X--------|--------------|--------|-----?---------------------o-------|-----
----------------------------------------|------------T-|---o-B---------------------|---M------|------o-----B--B-----o----|----B-|---M-|--------------|-----|-----------------B-XB------o----------|--B--
-----E--X--B----------------------------|---------B--|-|-B-E----------E------------|-B-----E--|-----------B--B-B---B-----|-|-----------o-----------------o-|-o|----------------X-------------X---B-----o
---o---Xo---------B---------------------|---B--------|-|---E-E------------BB------M|----------|-?---------o-B------------|-|--------X----|--o--o-----|----E|-------------------E--o---------E-T-----B--o
--XXXXXXXXXXXXXXXXXXXXXXXXXXXXXXXXXXXXXXXXXXXXXXXXXXXXXXXXXXXXXXXXXXXXXXXXXX-XXXXXXXXXXXXXXXXXXXXXXXXXXXXXXXXXXXXXXXXXXXXXXXXXXXXXXXXX-XXXXXXXXXXXX-XXXXXXXXXXXXXXXXXXXXXXXXXXXXXXXXXXXXXXXXXXXXXXXXXXXX
