--------------------------------------------------------------------------------------------------------------------------------------------------------------------------------------------------------
-------------------------------------------------------------------------------------------------------------------------------------------------------------------------------------------------------X
-------------------------------------------------------------------------------------------------------------------------------------------------------------------------------------------------------X
-------------------------------------------------------------------------------------------------------------------------------------------------------------------------------------------------------X
-------------------------------------------------------------------------------------------------------------------------------------------------------------------------------------------------------X
-------------------------------------------------------------------------------------------------------------------------------------------------------------------------------------------------------o
---------------------------E------E-----------------------------E---------------------------------------------------EBMBMB------------------E------------------------------------------------X----------
--------------------------------E-------------------B-B---E------------------------------------------------------------------------------?B?B--?B?----------------------------------------T------------v
----------------X-XX-----o-ooooo-----XX---X-----X---------------E--M------X------BMB---T---------------BT-X----?-MB-------XX--?--------E---------------?B?--E-------X-Xooo-E-----E--B?B-----E--E--X-XX-f
---------------Eoo--o--XX----?------------------?------XXX----X--XX--X-ooooo--------E-------oT----X-X--X-----B?-XXXXXT---------XT----T-XXX-----oo------E----------E----XXX-o-oo-E--?T--XX----X-X-------f
--T-X----XT------E------X----------------------------E-------XXEMB----------X----------E-?-?-?-XX-------------B?B-BM-?TEB-XXXXX-XXX---X-----ooooB------MMT-X---------B?B--------B?B------TT-XX--XX-X-T-f
--|--?T-B-|--------------E---E--E-------X---------XXX---E-----------XX-X--E-------XXXXX-----oo------------------E-----|-XX---E------X---------X---E---XT-|-------BXXX-------------XT-X---||----------|-f
---B?B|---|--E----------------------------------|--------?BMBMBB?B?----E------XX---XXX--M---------XX------------X--XXX|-T-E-B?-M-M-?B?--------o--------|-|---B--M------X---XXX--|--|-----||--M-----o---f
------|--------------E-----B-------------E------|-?-?B?-ooooo--o---o--------------------------------------------------|-|------------------------------|XXX-----------B|-B--X-X-|--|---E-||----------|-f
m-|---|-----?-------oo--------------------------|-------------------E------E-----E--------E--ooo-------B--BM---MB-----|-|------------------------X-----|-|-X-X-X-------|-XXX-X--|--|-XX--X|----------|-X
XXXXXXXXXXXXXXXXXXXXXXXXXXXXXXXXXXXXXXXXXXXXXX-XXXXXXXXXXXXXXXXXXXXXXXXXXXXXXXXXXXXXXXXXXXXXXXXXXXXXXXXXXXXXXXXXXXXXXXXXXXXXXXXXXXXXX-XXXXXXXXXXXXXXXXXXXXXXXXXXXXXXXXXXXXXXXXXXXXXXXXXXXXXXXXXXXXXXXXXX
