----------------------E--------------------------------------------XB------------------------------------------------------------B-------------------------------EB--------B----B-------------------B--X
-------BE--------------X----------------------------------------------B--------E-----B----E---------------------------------------MT------------------------------------------------E------------------E
E---------------------------------------------------------B----------B--------------?-------------------B---?----------------------|-BE--------E---------E---------?T----T-B--T-----B-------------E-----
B-------------------------B------------T--------------------B-----------------------B------------------B-----------------B-----M---|---------------X----------------|----|----|------------------------M
-E----E---------------------E----B-----|-T---------------------B--B------B-----------X------------------------------------E--------|-E---------E------E-------------|-M--|----|--------EB---B--B-------X
-----E-------------B-------B-----------|-|---------------B------------------------------E------------E-----------------------------|-E-----------------|--------T---|----|----|-----E-----------B----E--
--------B------------------------------|-|--T-------------------------|TT--------------B-E-------------------------BB--------------|---------------B------------|-E-|----------------------BE-----------
------------T---------------B---EE-------|--|------B--M--B------------|-|--------------------T----------B------T------T-----------E---------M----------------B------|-------------------EB-------------v
--------E-B-|---B---T------E----------------|--E---E------B-------E---|-|---------------E----|----------------||--------B--T-------|-E--------------------------------------------EE----------------B--o
------------|-------|-----------------------|---------E-------B---------|-----------|--------|----------------B|-----------|-----------------|-----------------------B------------------B---B-----------
------------|-------|----------------E?-----|---------------B-E-------|-|--E--E--------------|--T---------M-------E--------|-----------?--------E-E-B----E--------|-----------------B-------------------
B-----T-B-B--|--T-----E-----E------------|-B|----------------T----------|--------------------|--|-----|-----------B--------|-------------B--------B---------B----------------------------------------T-B
------|------|--|--E--ET----------B------|--|--------B-B-B?--|-----B---B|----------------X-----B|---------------------B----|------------E---------------E---------|--|-----------------------E-------|-?
X------------|--|------|--------B-----------|--E-----B----|--|----------|--T--B----------------E----B-|--T----E------------|-----------------|-------------------------------------------------------|--
m--------E---||-|-o-------------------------|----------------|----------|--|--------|-------------B---||-------------------|-----------------|----EE---?-----T--E-|----------------------------------|-X
XXXXXXXXXX-XXXX-XXXXXXX-X-X-XXX---X-----XX-XX--X-X---XXXX-X-XX-XXX--XX-XXX-XX-X---XX--XX--XX-X-X--X-X--X--X-X-X----X----X--X-X--XX-X-XX-X-X-----XX--X-X--X-X-X--XXXX--XX-X-X--X-X-XX-MXX-X-X-X--X-XXXXXX
