--------------------------------------------------------------------------------------M-----------------------------------------------------------------------------------------------------------------
--------------------------------------------------------------------------------------------------------------------------------------------------------------------------------------------------------
--------------------------------------------------------------------------------------------------------------------------------------------------------------------------------------------------------
--------------------------------------------------------------------------------------------------------------------------------------------------------------------------------------------------------
-----------------------------------------------------------------------------------?----?------M--------------------------------------------------------------------------------------------------------
--------------------------------------------------------------------------------------------------------------------------------------------------------------------------------------------------------
------------------------------------------------------------------------------------------------o-------------------------------------------------------------------------------------------------------
--------------------------------------------------------------------------------------------------X-------T--------------------------------------------------------------------------------------------v
----------------------------------------------------------------------------------------------------------|--------------------------------------------------------------------------------------------f
----------------------------------------------------------------------------------------------------------|--------------------------------------------------------------------------------------------f
----------------------------------------------------------------------------------------------------------|--------------------------------------------------------------------------------------------f
----------------------------------------------------------------------------------------------B-----B-----|--------------------------------------------------------------------------------------------f
----------------------------------------------------------------------------------------------------------|-----X--------------------------------------------------------------------------------------f
----------------------------------------------------------------------------------------------------------|--------------------------------------------------------------------------------------------f
m---------------------------------------------------------------------------------------------------------|--------------------------------------------------------------------------------------------X
XXXXXXXXXXXXXXXXXXXXXXXXXXXXXXXXXXXXXXXXXXXXXXXXXXXXXXXXXXXXXXXXXXXXXXXXXXXXXXXXXXXXXXXXXXXXXXXXXXXXXXXXXX|XXXXXXXXXXXXXXXXXXXXXXXXXXXXXXXXXXXXXXXXXXXXXXXXXXXXXXXXXXXXXXXXXXXXXXXXXXXXXXXXXXXXXXXXXXXXX
