-------------------------------------B-----BE---------------------------------------------------------------------------------------------------------------------------B-------------------------------
----------------------T---B----B------B--------------E-----B---------------------E----------------------T-------B------------T---------------E-------------------------------------B-------------------T
------B-------B--------------------E----T--T---------------------------------------------------------------------------------------------E-----------------------------------------B-B----------------BX
-------------------------------------------------------------------E---------------------------T-----E-----------TB-B----------------------------------------------------------------B----B---------B--B
-----T----------------------------------------------------B--------------B----------------T----------------------------------------------------------------------------------------------B--B----------B
---T---------------------------B---------------------------------BB-----------------------------E---------B--------------------------B---------------------BB-----------------------------------------E-
---|-|---------------------------------|--------------------------X--------------------|--------------------------E-----------------------B----------------------------------|----B--------------------X
---|-|-------E-----------------B-------|-----B-E---------------------------------------|--|------------------------------------------------------------------------E---------|----T--------------------v
---|-|---------------------------------|----------------------EB-----------------------|--|-----------------------------------------------------------------B---------B-----------|---------------------
---|-|---------------------------------------T--------B-B-----------------------B-T----|-B|------------------------------------------B----------------------E--------------------|---------B------------
---|-|---------|----------------------------B|---------X-------------------------E-----|----------------E--------------------|----|----------------E-------------------------|----|-|----E--------------
---------------|-----------B----------T------|------------------?---------E--B-|----------------------------------------E-E-------------------------B-B----------------------|---||--------------------X
-------------------------------B--B---||-----|-----------T---------------------|--|----|--|------------------------------B-B---BT-|----------------------------------------|-|---||-----------B--------M
-----|---------|---E------------------|--|-------------------------------------|--|----|--|---|-E-----------------------B----|-------------------E----E-------T--|---B-----------||-|----------------E--
m------E--B----|----------------------||-|---------------|--------T-----B---------|-------|---|----------------------------E-|----|---------------------------|--|----------------|---------E----|----BE
X-XXXXX-XX-XX---X---X--X-XXX----XX-XX-X--XX--X------XXX-XX--XX-X-XX-X-X-------XXX--X-XX----X--X-X---XX-XXX--XX----X-X-XXXXX--X--X---XX---X--X---X---X--X-X-XXXXX-XXXXX--X--X------X--X-X--X-X-X---XXXXXX
