--------------------------------------------------------------------------------------------------------------------------------------------------------------------------------------------------------
--------------------------------------------------------------------------------------------------------------------------------------------------------------------------------------------------------
--------------------------------------------------------------------------------------------------------------------------------------------------------------------------------------------------------
--------------------------------------------------------------------------------------------------------------------------------------------------------------------------------------------------------
--------------------------------------------------------------------------------------------------------------------------------------------------------------------------------------------------------
--X-----------------------------------------------------------------------------------------------------------------------------------------------------------------------------------------------------
--XX----------------------------------------------------------------------------------------------------------------------------------------------------------------------------------------------------
--XXX------------------------------------------------------------------------------------------------------------------------------------------------------------------------------------------?-------v
--XXXX-------------------------------------------------------------------------------------------------------------------------------------------------------------------------------------------------f
--XXXXX------------------------------------------------------------------------------------------------------------------------------------------------------------------------------------------------f
--XXXXXX-----------------------------------------------------------------------------------------------------------------------------------------------------------------------------------------------f
--XXXXXXX----------------------------------------------------------------------------------------------------------------------------------------------------------------------------------------------f
--XXXXXXXX---------------------------------------------------------------------------------------------------------------------------------------------------------------------------------------------f
--XXXXXXXXX--------------------------------------------------------------------------------------------------------------------------------------------------------------------------------------------f
m-XXXXXXXXXX----------------------------------------------------------------------------------------------------------------------------------------------------------------------------------------o--X
XXXXXXXXXXXXXXXXXXXXXXXXXXXXXXXXXXXXXXXXXXXXXXXXXXXXXXXXXXXXXXXXXXXXXXXXXXXXXXXXXXXXXXXXXXXXXXXXXXXXXXXXXXXXXXXXXXXXXXXXXXXXXXXXXXXXXXXXXXXXXXXXXXXXXXXXXXXXXXXXXXXXXXXXXXXXXXXXXXXXXXXXXXXXXXXXXXXXXXXX
