-------------------------------------------------------------------------------o-----------------------------------------X-----------------------------------------------o------------------------------
---------------------------------------------------------------B----------------------------------------------------------------------------------------------------------------------------------------
---------------------------------------------------------------------------------------------------------------------------------------------------------------------------------------------X----------
-------------------------------------------------------------------------------X------------------------------------------------------------------------B-----------------------------------------------
-------------------------------------------------------------------------------X----------X-----T----------------------------------------------------------------------------------?-------------B------
--------------------------------------------T-------------------------------------M------XX-???o|??----------------------T------------------------------------------------------------------------------
-----------------------------T--------------|-------------------------------------------XXX-----|------------------------|-----------------------------------------------------------B------------------
-----------------------------|--------------|----------------------------------------XXXXXX-----|------------------------|------B----------------------------------------------------------------------v
-----------------------------|--------------|-----------------------------------------XXXXX-----|-----X-------------T----|-----------------------------------------------------------------------------f
-----------------------------|------T-------|-------------T--------------------------XXXXXX-T---|----XX-------------|----|-----------------------------------------?-----------------------------------f
-----------------------------|------|-------|-------------|-------------------------XXXXXXX-|---|---XXX-------------|----|-----------------------------------------------------------------------------f
-----------------------------|------|-------|-------------|------------------------XXXXXXXX-|---|--XXXX-------------|----|-------------------------X---------------------------------------------------f
-----------------------------|------|-------|------------?|-----------------------XXXXXXXXX-|---|-XXXXX-------------|----|--T--------------------------------------------------------------------------f
-----------------------------|------|-------|-----------T-|-----------------T----XXXXXXXXXX-|---|XXXXXX-------------|----|--|--------------------------------------------------------------------------f
m----------------------------|------|-------|-----------|-|-----------------|-E-XXXXXXXXXXX-|---|XXXXXX-E-----------|----|--|---------------E-----E---------------E-----------------E------------------X
X----XXXXXXXXXXXXXXXXXXXXXXXX|XXXXXX|XXXXXXX|-----XXXXXX|X|XXXXXXXXXXXXXXXXX|XXXXXXXXXXXXXXX|XXX|XXXXXXXXXXXXXXXXXXX|XXXX|XX|XXXXXXXXXXXXXXXXXXXXXXXXXXXXXXXXXXXXXXXXXXXXXXXXXXXXXXXXXXXXXXXXXXXXXXXXXXX
