-------------------------------------------------------------------------------------------------------------------------------------------------------------------------------------------------------T
-----------------------------------------------------------------------------------------------------------------------------------------------------------------------------------------------------XT-
-------------------------------------------------------------------------------------------------------------------------------------------------------------------------------------------------------X
--------------------------------------------------------------------------------------------------------------------------------------------------------------------------------------------------------
-------------------------------------------------------------------------------------------------------------------------------------------------------------------------------------------------------X
-------------------------------------------------------------------------------------------------------------------------------------------------------------------------------------------------------X
----T-----------------------XXX--o-oo-----------------------------X-BMB---XXX------------X--E-------------E-----------E----------------X--E-----------------------X----------------B?B------------------
----------------------X---------------------------------------?-?--------------------------------E----------------------B--?-----------------------------------------------------------?B-------?B?B---v
-------------------------------------X----oT-ooooo-------X-X------------------------ooo---------B-BXX----o------B?E----------B?B?-?B?B--B----B?-------------------------XX-X--------------o---------B--f
--------?------------------EE---X-----E-----XXX-------------T-B-----XT--E---XT-X-E-----E------------XXX-oooo--?-?-?-ToX--------B-B--------BMB--XXX-----ooooo-B?BX-X--X------ooooXXX--ooo--o--X---T--XT-f
---T----------------------------B-BB--E------X---XXXX-------o---?B?------------?B?X----B------------XXX----------------X---XXXXXXX--------------o--o-------------------X--X--------B?B?B----------X----f
---|---------XT-XXX-----------------------------XXXXX--XX--------X-X?B?B-?------XXX---M----XX-T-X---X-X-B?B----o---X--E----------------M-?B-------XXX--E----T-M----------E------B?B-----X-M---------X--f
---|----------|----M-------------------M----E--?B?-E-----------------|------------------------|----M----?----------XT--E-------XX-----------B?B-------------|--------------X---------------------------f
--X------X----|-------------------------------------------XXX---ET---|---X--------------------|---E-----B----?------|--oE--E----T-X-X-?B?B-----------X------|--E----XX-----E---------------------T-----f
m--|--B?B-----|----E------------ooooo-E--------E------XXXXXT-X---|---|----X-----XT------------|--------E|-----------|-----oo---X|-T----?-?----------BMB-B?B?B----XXX--X-------E-XXX------E-------|--E--X
XXXX--X-XXXXXXXXXXXXXXXXXXXXXXXXXXXXXXXXXXXXXXXXXXXXXXXXXXXXXXXXXXXXXXXXXXXXXXXXXXXXXXXXX-XXXXXXXXXXXXXXXXXXXX-XXXXXXXXXXXXXXXXXXXXXXXXXXXXXXXXXXXXXXXXXX-X-XXXXXXXXXXX-XXXXXXXXXXXXXXXXXXXXXXXXXXXXXXXX
