--------B-----X-X----?----------------X--o---------?-----------------X---------X---M-----XM-----E---------------M-B----------o----M-X--------X----------B------oX-?--M-----XX-----X----TB--------o--E---
---o--------X------------------B---------------------o------------------------B-o-------?--X---X---E-----?-X----------X-------------------B----E-------X----o----X-B-----------B-------T----------M-----
--------B--------B-X----------------------------E-------------------M--------X-------------------------------o----------o-----------X-----------M--Xo-X--------o-------------------M------------------T-
-------------------X---M-----B-X----?--------?X---------?-------B--o----E----X------E----M--------------------o----X---------------------------o----------------------------------------B-B------X------
-----BE---B-T-------------------------o-------o------------o-----E----oXo--------B-----X-------B-----B------------------X--------------------------X----M-----------X---XX-----------------B-------X-B-X
--------oEX-|---------ooM-X-----------X--------------B-o---------o----------B-?---------------X---B--o--B---------------------o----------X-?B-------------------BBX--M--M--------------------o-------B--
------------|---------E----------------o--?--------------------------------X------------------------------B--E----X---o-----BE---|-----------------X-------------o-?---B----o--------------------?-----X
------------o-----B-------------------o------X-X------X-------T-|X---X--o----------X-X-T------X----X--------------X-o--X--------X|--------E---?------T------------T-----E--B----o----oX-------------E--v
--X--B----E-|--M--Bo---------------B--------B-?-X--------o-----------X---B-------------|----X-----------B----|---X------EX-------|X--------------------T-------------o----------------------?--------B-o
---------B-B|-E----T----------------|---o-B--o------------?---|-o-EX--B----------------|----------------BX---|--B------------------------------T-X--o--|X------T--|---?---------------M-----------------
---E--------|-----B-----X----?------|-----------|-------------|-------B-------X-----E--|--------------------------o--------------|---B------X--|---?-|-|-------|----o---------X-----------X----B--------
-----------Eo---?X-----------------Xo------oTX--oM---X--------|-------T--M--B---------o---------------X----------o--?-B----B-----|---T-o-------|o----|-X--B--B|---|-E--B--X-----------------------------
---o--------|------|--X---o-----o|--|------B|-----------B-----|-|-----|---E------------|?-------M--?----E----|---o-----------B---|--B--T-----X----|--|-|--E---||--|---------B---X----------------MM----?
X-|----------X----------------------|----------oXX----------T-|-----B-|--------B----B--|---------------------|-------------------|---|---------|--|--|--------||----------------------------T------E---T
m-|---?------------|----------------o-B------------------B-E|---------|-------------------------B------------|----B--------------|---|-|-------|--|----|------||-----------------E-B-------X------------
XXXXXXXXXXXXXXXXXXXXXXXXXXXXXXXXXXXXXXXXXXXXXXXXXXXXXXXX-XXXXXXXXXXXXXXXXXXXXXXXXXXXXXXXXXXXXXXXXXXXXXXXXXXXXXXXXXXXXXXXXXXXXXXXXX-XXXXXXXXXXXXXXXXXXXXXXXXXXXXXXXXX-XXXXXXXXXXXXXXXXXXXX-XXXXXXXXXXXXXX
