-------------------------------------------------------------------------------------------------------------------------------------------------------------------------------------------------------X
-------------------------------------------------------------------------------------------------------------------------------------------------------------------------------------------------------M
-------------------------------------------------------------------------------------------------------------------------------------------------------------------------------------------------------X
--------------------------------------------------------------------------------------------------------------------------------------------------------------------------------------------------------
--------------------------------------------------------------------------------------------------------------------------------------------------------------------------------------------------------
--------------------------------------------------------------------------------------------------------------------------------------------------------------------------------------------------------
------------oooE--------------o----X-------------------?---------------------------------------------------?B?B?-?B-B------------------------------?-------o-o-oooo---XXX--------------XXXX-----E-------
--------------------------------------------------------XXXXE-E--------------------------------XT-------E------------------------------ooooo-----------------------------------------XX--X-------XX----v
----------------E---------------------------------X---T-o----E-------T-B----------------B--T---------oooo-----E-------------------o----------E---XXXX-----------X-B?B-----XX----------X-X-?B?B--XX-XX--f
--?-XXXX----------ooooo--o-----XX---------------E---------T-X----------------E-------------------E---XT-------o-o--?----------------X----XXE-----------oooo---E--------B?B?-------------M--------------f
----------E----------------X-XXX---------------------------XX--------o--------------------E---T-X--oo---?-------E------XXX------T----------X----------------X----E--XXXX--XX-T-XXXXX--X--B------X------f
------------------?---?B?B?X----E------E-----------------ooo?-----M---------------X---------?T|----o---BM-----------------------|--------------T-T---XX----XEE--X---XXXX-----|-X----oooX-X--E-?B?B?----f
----------------------X--------XXT-X---------XXX------XXX----------E-------------------------|---E---?BM------E------XXXMBT---E-|---T----------|-|-?T--T-B---X-------M-?--B?B?----------------X--------f
----------------------------ooooo|------T-o--------X-X--------------X-----------?-?B?B-------|---XXX-X----o-----o--------E|-----|B--|----------|-|--|--|-|--E----------X-----|---------X---------------f
m------------------E-------------|----o-|--------XX----X-XX---------------XX-XXXXX---?-------|-----Eooo-------------------|-----|---|----------|-|--|--|-|XXX---B?BE--XXXXXXXXX----ooooo--?-?-oooo---E-X
XXXXXXXXXXXXX-XXXXXXXXXXXXXXXXXXXXXXXXXXXXXXX-XXXXXXX-XXXXXXXXX-XXXXXX-XXXXXXXXXXXXXXXXXXXXXXXXXXXXXXXXXXXXXXXXXXXXXXXXXXXXXXXXXXXXXX-XXXXXXXXXXXXXXXXXXXXXXXXXXXXXXXXXXXXXXXXXXXXXXXXXXXX-XXXXXXXXXXXXX
