-------------------------------------------------------------------------------------------------------------------------------------------------------------------------------------------------------X
-------------------------------------------------------------------------------------------------------------------------------------------------------------------------------------------------------M
-------------------------------------------------------------------------------------------------------------------------------------------------------------------------------------------------------X
--------------------------------------------------------------------------------------------------------------------------------------------------------------------------------------------------------
--------------------------------------------------------------------------------------------------------------------------------------------------------------------------------------------------------
--------------------------------------------------------------------------------------------------------------------------------------------------------------------------------------------------------
------------oooE--------------o----X-----------------------------o-----------------------------------------?B?B?-?B-B------------------------------?-------o-o-ooo----X-X--------------XXXXX----E-------
--------------------------------------------------------XXXXE-E--------------------------------XT-------E------------------------------oo-oo-----------------------------------------XXX----------X----v
----------------E---------------------------------X---T-o----E-------T-B----------------B--T---------oooo-----E-------------------o----------E---XXX------------X-B?B----------------X----?B?B--XXXX-X-f
--?--XXX----------ooooo--o----XXX---------------E---------T-X----------------E-------------------E---XT---------o--?----------------X----XXE-----------oooo---E-------?B?B?-------------?--------------f
----------E----------------X-XXX--------------------------XXX--------o--------------------E---T-X--o----?-------E-------X-X-----T----------X----------------X----E--XXX---XX-T-XXXXX--X--B------X------f
------------------?---?B?B?X----E------E------------------o-?-----M---------------X---------?T|----o---BM-----------------------|--------------T-T---XX----XEE--X---XXXX-----|-X----oooX-X--E-?B?B?----f
----------------------X--------XXT-X----------X--------X-----------E-------------------------|---E---?B?------E------XXXMBT---E-|---T----------|-|-?T--T-B---X---------?--B?B?B---------------X--------f
---------------------------oooooo|------T-oo-------X-X--------------X-----------?-?B?B-------|---XX-XX----o-----o--------E|-----|B--|----------|-|--|--|-|--E----------X---------------X---------------f
m------------------E-------------|----o-|--------XX----X-XX---------------XX-XXXXX-----------|-----E-o--------------------|-----|---|----------|-|--|--|-|------B?BE--XXXXXXXXX----ooooo--?-?-oooo---E-X
XXXXXXXXXXXXX-XXXXXXXXXXXXXXXXXXXXXXXXXXXXXXX-XXXXXXX-XXXXXXXXX-XXXXXXXXXXXXXXXXXXXXXXXXXXXXXXXXXXXXXXXXXXXXXXXXXXXXXXXXXXXXXXXXXXXXXXXXXXXXXXXXXXXXXXXXXXXXXXXXXXXXXXXXXXXXXXXXXXXXXXXXXX-XXXXXXXXXXXXX
