-----------------------------------------E------------------------E-------------?----------------------------------------------------------------------------------------------------------------------X
-------B---------------------------------------------B---------------E--------------------------------------------------------------------------X-----------------------------------------B------------M
-----------------------E-B----------------T------------------------------------------T-------M---------------------------------B-------------------E---------------------------------------------------o
------E--------------------------------B-T---------------------------------------T----M---------X---------------B--------------------------------------------B----B----?-------------------------------B
-------BB-------------------T----T-------------------T--EB---------------------------------------------------------------B------------------------------------------------------------------?-----------
----E------------B----------|----|-----------------E-|----T-----------------B-----------------------------------------------------------E--------------T-----------------X------X----------------------X
---------------------------T|-------------------E----|--ET|-------B------------------------------T-----------------T------------------------------------------------B----B------------------------B-----
-----E-----------E----------|----|-------------------|---|----B------------------------------------------------------------------------------------------B--------------------------------------------Bv
----------------------------------------------------------|-B-------B----E-----------------------------------|-----|-----------------------------------|--E--B------------------T-----------------------
----------------------------|------------E-----------|---||----E----------------------X------------------------------------------------|-------B---------B-------------B--------------------------------
-------------|-----------BT|----------------------B-X|----|-B----E-----------?----------------E--?---E-------------|-------------------|---------------|----------------B------------B------------------
-------------|-|---------T|||-------------E----|---------||--------------------------------------|X---B------|-----|-----------B-------|---B--------------------------E---------|---B-------------------
-------------|--------------|------------------|-----|---||----------------------------------B---|-----------------|-------------E-------------------B------B------------------------------B--B---------
o--------------|--E------||-|----|----------------E--|----|-------------------------B---------B--------------|-----------------------------B------------------------------------|-B-----------------E---
m--------------|---------|--|------------------|---E-|----|---T---------B---------------------B-B-------E----------|----B|---------------------------------------------E---B--B-|------T-------B-B------
X-XXXXXX-XXX--XX-XX---XXX-X----X--XX------XXX-XX---XXXX---X-XX-X----XX---X-------XXX-XX---XX----X--X---X------X-X-XX------X--XXXX---XX-X-XXX-X-X-X----XXXX----X--XX-XX-XXX-X--XXXX----X-----X--XXXXXXXXX
