--------------------------------------------------------------------------------------------------------------------------------------------------------------------------------------------------------
--------------------------------------------------------------------------------------------------------------------------------------------------------------------------------------------------------
----------------------------------------------------------------------------------------------------------------------------------------------------------------------------------------------------M---
--------------------------------------------------------------------------------------------------------------------------------------------------------------------------------------------------------
--------------------------------------------------------------------------------------------------------------------------------------------------------------------------------------------------------
--------------------------------------------------------------------------------------------------------------------------------------------------------------------------------------------------------
----------o---------------------------------------------------------------------------------------------------------------------------------------------------------------------------------------------
-------------------------------------------------------------------------------------------------------------------------------------------------------------------------------------------------------v
--T----------------------------------------------------------------------------------------------------------------------------------------------------------------------------------------------------f
--|----------------------------------------------------------------------------------------------------------------------------------------------------------------------------------------------------f
--|----------------------------------------------------------------------------------------------------------------------------------------------------------------------------------------------------f
--|----------------------------------------------------------------------------------------------------------------------------------------------------------------------------------------------------f
--|--------M-------------------------------------------------------------------------------------------------------------------------------------------------------------------------------------------f
--|--T-------------------------------------------------------------------------------------------------------------------------------------------------------------------------------------------------f
m-|--|--E----------------------------------------------------------------------------------------------------------------------------------------------------------------------------------------E--X--X
XX|--|XXX----XXXXXXXXXXXXXXXXXXXXXXXXXXXXXXXXXXXXXXXXXXXXXXXXXXXXXXXXXXXXXXXXXXXXXXXXXXXXXXXXXXXXXXXXXXXXXXXXXXXXXXXXXXXXXXXXXXXXXXXXXXXXXXXXXXXXXXXXXXXXXXXXXXXXXXXXXXXXXXXXXXXXXXXXXXXXXXXXXXXX----XXX
