----------------------------------E------------------------------------------------------E--------------B--B--------------------T----B----------------------------------------------E------------E--B---
---------------------------------------EB----------------------------------------------------------------------------B------B-------------------------E--------E----------------------------------------
-------------------------------------------------------------------B-----------------------------------------------------------------------------B---B---------------------------B----------------------
---------BB---------------------------------BB----------------------------o-----------------------E-----------------------------------------------B----------------------------------------------T------
-----------E--E-------------------B-----T------------------------T-------------------T--------B--------------------------------------------BB---------------------------------------------------------B-
-------------E----B-------------------------B-----E---------------------------B--B---------------E-------------T-------E--T---------------------B-------------------?-B---------------------B-----------
--------B-B--------E--------------E------------------------B----------------------------------------------------------------------------------E------------------------------------B--------------------
-----T------------------------------B-----------------------------B-----------------------------------------------------------T------------------------------------------------------------------------v
-----------B--------------------------------------------------B---------E-----------------T----------------------------------------------?----------------------------E-----------------------T---------
--------B----T----------------------------------------B---------------------------BB------|--------------------------------------------------------------------------------------B------|-E---|---------
X----------------------------------B--B-------------------B----------B--------------------|----------------T-------|------------T--B-----------------E-----------------------------E----------|---------
----T------T-|------------------E-----------------------B---------------------------E---E-|--B-------------|-------|---B-------------B-E---------------------E--------------------------|-----|---------
----|------|-|-------------------------------B-B------------------B---T-------------------|----E?----E-----|-T-----|-----------B|-----------E----------------------------B--------------|-----|---------
B---|------|-|---------------B---B----------------E------------B------|---------------B---|----------------|---------------------------------------------------------E------------------|-----|---------
m---|------|-|-------E-----------E-----------------B------------------------------------T-|-------------------------------------|--------------E----------------------------------------|-----|-B----BB-
X-XXXXX-XX-X-XX-XX-XXX--X------X-----X-X--XXXX--XX------XX-X---------X-X--X-XX---XX-----------X----XX--X-XX-X-X----XX-XXXX----X-X-XX-XX-XX-XX--XXXXX--XX----X---X--XX--XX---X-X-XXXXX--XX-X---XX-XXXXXXX
