-------------------------------------------------------------------------------------------------------------------------------------------------------------------------------------------------------X
-------------------------------------------------------------------------------------------------------------------------------------------------------------------------------------------------------M
-------------------------------------------------------------------------------------------------------------------------------------------------------------------------------------------------------X
--------------------------------------------------------------------------------------------------------------------------------------------------------------------------------------------------------
--------------------------------------------------------------------------------------------------------------------------------------------------------------------------------------------------------
--------------------------------------------------------------------------------------------------------------------------------------------------------------------------------------------------------
------------oooE--------------o---XXX------------------?---------o-----------------------------------------?B?B?-?B-B------------------------------?-------o-o-ooo----XXX--------------XXXXX----E-------
--------------------------------------------------------XXXXE-E--------------------------------XT-------E------------------------------oo-o------------------------------------------XXX---------XX----v
----------------E---------------------------------X---T-o----E-------T-B----------------B--T---------oooo-----E-------------------o----------E---XXX------------X-B?B------X---------XX-X--B-B--XXXXXX-f
--?-XXXX---------oooooo--o----XXX---------------E---------T-X----------------E-------------------E---XT------oooo--?----------------X----XXE-----------ooooo--E--------B?B?-------------?--------------f
----------E----------------X-XXX---------------------------XX--------o--------------------E---T-X--oo---?-------E------XXXX-----T----------X----------------X----E--XXXX--XX-T-XXXXX--X--B------X------f
------------------?---?B?B?X----E------E----------------ooo-?-----M---------------X---------?T|----o---BM-----------------------|--------------T-T---XX-----EE--X---XXXX-----|-X----oooX-X--E-?B?B?----f
----------------------X--------XXT-X----------X-------XX-----------E-------------------------|---E---?B?------E------XXXMBT---E-|---T----------|-|-?T--T-B---X-------M-?--B?B?----------------X--------f
----------------------------ooooo|------T-oo-------X-X--------------X-----------?-?B?B-------|---XXXXX----o--------------E|-----|B--|----------|-|--|--|-|--E----------X-----|---------X---------------f
m------------------E-------------|----o-|--------XX----X-XX---------------XX-XXXXX---M-------|-----E-o--------------------|-----|---|----------|-|--|--|-|-X----B?BE--XXXXXXXXX----ooooo--?-?-oooo---E-X
XXXXXXXXXXXXX-XXXXXXXXXXXXXXXXXXXXXXXXXXXXXXX-XXXXXXX-XXXXXXXXXXXXXXXXXXXXXXXXXXXXXXXXXXXXXXXXXXXXXXXXXXXXXXXXXXXXXXXXXXXXXXXXXXXXXXX-XXXXXX-XXXXXXXXXXXXXXXXXXXXXXXXXXXXXXXXXXXXXXXXXXXXX-XXXXXXXXXXXXX
