-------------------------------------------------------------------------------------------------------------------------------------------------------------------------------------------------------X
-----------------------------------------------------------------------------------------------------------------------------------------------------------------------------------------------------E-X
-----------------------------------------------------------------------------------------------------------------------------------------------------------------------------------------------------E--
-------------------------------------------------------------------------------------------------------------------------------------------------------------------------------------------------------X
-------------------------------------------------------------------------------------------------------------------------------------------------------------------------------------------------------M
--------------------------------------------------------------------------------------------------------------------------------------------------------------------------------------------------------
--------B-E--------?BM-------E-------------?-------------XX-X---T------XXX-------------------oo-oo---E-----XX--B?B-MB?B?------?-------------------X-X----?B--X------------------ooooX-------------o----X
----------E------------------XXX-------oo------oooooo-----------------------B?------------------E--------M---------------B?------?-----E------------------T----------oooo---------------E----XX----?B?-v
--------T----E--E----------M--XXXXXX--E--------?--E-------------X---XTE-----------------------X-XX-XX-----X-X----------------------X-XXXX----MXX--E---------X-X--oo-o-MB?B?--XXX-XX--MB-------X--------f
-----E-----XXXX---?------------XXX------XX-------X--------------XX--X-----E------T-X------------------------E--X---------------XX--X-X----XTE----XXX-XX-?--X-----T-M-----------X------------X-XXXX-----f
--X------------MB?-M-?B------------------------------M-?----------------B----------o-------?-?--o-B?--------------B?B?B--B-XTEo------T--B-------?B?B-B?B?---E--------------------------oooo-----------Tf
--E---------oooo-------XXX---XXXXX-----------o-oT-o-------X-BMB-----T-o---T-------M-----E-XXXX-----------?B-----------XX-X-X|-XX--XXXXX------------ooo--------------E----XXXXXXXT-X-----------------X-|f
----------?---------?---------TEX----XX---------|----------o---XXXXX|--BM-|--X----X--------B?B?B----XXX------------XX-X-----|--------o-X?B?-?-----XXXX--------E----?B?--|----?--|---------?TEX--------|f
---XXXX-----o-----B?-M--------|------------EE--E|---oo-----X-----X-X|--X-E|------XX---------------X-----------X-------------|-----------------------------------MB--------------|----------|-----T----|f
m-----E----XX----------E-E----|--------B?B-B----|-----MT----XXX-----|-----|-T-M---E----E---T--E---E-B?---X-?B?BMo--MB-------|--------|----oooooX---------------------XX--------?|----------|--X--|--E-|X
XXXXXXXXXXXXXXXXXXXXXXXXXXXXXXXXXXXXXXXX-XXXXXXXXXXXXXXXXXXXXXX-XXXXXXXXXXXXXXXXXXXXXXXXXXXXXXXXXXXXXXXXXXXXXXXXXXX-XXXX-XXXXXXXXXXXXXXXXXXXXXXXXXXXXXXXXXXXXXXXXXXXXXXXXXXXXXXXXXXXXXXXXXXXXXXXXXXXXXXX
