--------------------------------------------------------------------------------------------------------------------------------------------------------------------------------------------------------
----------------------------------------------B---------------------------------------------------------------------------------------------------------------------------------------------------------
--------------------------------------------------------------------------------------------------------------------------------------------------------------------------------------------------------
--------------------------------------------------------------------------------------------------------------------------------------------------------------------------------------------------------
--------------------------------------------------------------------------------------------------------------------------------------------------------------------------------------------------------
-------------------------------------------------X----------------------------------------------------------------------------------------------------------------------------------------M-------------
------------------------------------------------XX--T---------------------------------------------------------------------------------------------------------------------------------------------------
-----------------------------------------------XXX--|--------------------------------------------------------------------------------------------------------------------------------------------------v
----------------------------------------------XXXX--|--------------------------------------------------------------------------------------------------------------------------------------------------f
--o------------------------------------------XXXXX--|--------------------------------------------------------------------------------------------------------------------------------------------------f
--------------------------------------------XXXXXX--|--------------------------------------------------------------------------------------------------------------------------------------------------f
-------------------------------------------XXXXXXX--|--------------------------------------------------------------------------------------------------------------------------------------------------f
-o----------------------------------------XXXXXXXX--|-----------------------------------------------------------------------------------X--------------------------------------------------------------f
-----------------------------------------XXXXXXXXX--|-----------------------------------------------------------------------------------XX-------------------------------------------------------------f
m---------------------------------------XXXXXXXXXX--|-----------------------------------------------------------------------------------XXX----------E-------------------------------------------------X
XXXXXXXXXXXXXXXXXXXXXXXXXXXXXXXXXXXXXXXXXXXXXXXXXXXX|XXXXXXX------XXXXXXXXXXXXXXXXXXXXXXXXXXXXXXXXXXXXXXXXXXXXXXXXXXXXXXXXXXXXXXXXXXXXXXXXXXXXXXXXXXXXXXXXXXXXXXXXXXXXXXXXXXXXXXXXXXXXXXXXXXXXXXXXXXXXXX
