-----------------------------------------E------------------------E------------------------------------------------------------------------------------------------------------------------------------X
-------B---------------------------------------------B---------------E----------------------------------------------------------------------------X---------------------------------------B------------M
-----------------------E-B----------------T------------------------------------------T----------X------------------------------B-------------------E---------------------------------------------------o
------E--------------------------------B-T------------------------------------M--T------------------------------B--------------------------------------------B--?-B------------------------------------B
-------BB-------------------T----T-------------------T--EB---------------M-----------------------------------------------B----------------------------------------X-------------------------------------
----E------------B----------|----|-----------------EX|----T-----------------B---------M-------------------------------------------------E--------------T-----------------------------------------------X
---------------------------T|-------------------E----|--ET|-------B------------------------------T-----------------T------------------------------------------------B----B------------------------B-----
-----E-----------E----------|----|-------------------|---|----B------------------------------------------------------------------------------------------B--------------------------------------------Bv
----------------------------------------------------------|-B-------B----E------------X----------------------|-----|-----------------------------------|--E--B------------------T------?----------------
----------------------------|------------E-----------|---||----E-----------------------------------------------------------------------|-------B---------B-------------B----------X---------------------
-------------|-----------BT|----------------------B--|----|-B----E----------------------------E------E-------------|-------------------|---------------|----------------B------------B------------------
-------------|-|---------T|||-------------E----|---------||--------------------------------------|--XMB------|-----|-----------B-------|---B--------------------------E---------|---B-------------------
-------------|--------------|------------------|-----|---||----------------------------------B---|-----------------|-------------E-------------------B------B------------------------------B--B---------
o--------------|--E------||-|----|----------------E--|----|-------------------------B---------B--------------|-----------------------------B------------------------------------|-B-----------------E---
m--------------|---------|--|------------------|---E-|----|---T---------B---------------------B-B-------E----------|----B|---------------------------------------------E---B--B-|------T-------B-B------
X-XXXXXXXX-X-XXX-XX-XX-XXXX----X-X---XXXX-X----X--XX-XXXX-X--X-X--X-X------XX------XX-X--XX---X--X--XXXX---X-XXX-XXXX-X---XX-X--X-X-XXX-XX-XX-XXX--XX--X----X----XX-XX-XXX-XXX----X--X--X--X-XX-XXXXXXXX
