-------------------------------------------------------------------------------------------------------------------------------------------------------------------------------------------------------T
-----------------------------------------------------------------------------------------------------------------------------------------------------------------------------------------------------XT-
-------------------------------------------------------------------------------------------------------------------------------------------------------------------------------------------------------X
--------------------------------------------------------------------------------------------------------------------------------------------------------------------------------------------------------
-------------------------------------------------------------------------------------------------------------------------------------------------------------------------------------------------------X
-------------------------------------------------------------------------------------------------------------------------------------------------------------------------------------------------------X
----T-----------------------XXX--o-oo-----------------------------X-BMB----X-------------X--E-------------E-----------E----------------X--E-----------------------X-----------------?-------------------
----------------------X---------------------------------------?-?--------------------------------E----------------------B--?---------------------------------------------------------?-?B-------MBMB---v
-------------------------------------X----oT-oo-ooo--------X------------------------ooo---------B-XXX----o-----?B-E----------B?B?-?B?B--B-----?-------------------------X--X--------------o---------B--f
--------?------------------EE---X-----E-----XXX-------------T-B-----XT--E---XT-X-E-----E------------XXX-oooo--?-?-?-ToX--------B-B----------B--XXX-----ooooo?B?XXXX--X------ooooXXX--ooo--o--X---T--XT-f
---T----------------------------B-BB--E-----XXX---XXX-------o--B?B-------------?BXX----B------------XXX---------------XXX-XX-XXXX---------------o--o-------------------X--X--------B?-?B----------X----f
---|---------XT-XXX-----------------------------XX--X--XX--------X-X?B?B-M------XXX---M-----X-T-X---X-X?B?B?---ooo-X--E----------------?B?B-------XXX--E----T-M----------E------B?B-----X-M---------X--f
---|----------|----M-------------------M----E------E-----------------|------------------------|----M---------------XT--E-------XX-----------B?B-------------|--------------X---------------------------f
--X------X----|-------------------------------------------XXX---ET---|---X--------------------|---E-----B----?------|--oE--E----T-X-X-?B?B-----------X------|--E----XX-----E---------------------T-----f
m--|----------|----E------------ooooooE--------E------XXXXXT-X---|---|----X-----XT------------|--------E|-----------|----ooo---X|-T---B?B?-----------MB-B?B?B----XXXX-X-------E-XX-------E-------|--E--X
XXXXXX---XXXXXXXXXXXXXXXXXXXXXXXXXXXXXXXXXXXXXXXXXXXXXXXXXXXXXXXXXXXXXXXXXXXXXXXXXXXXXXXX-XXXXXXX-XXXXXXXXXXXX-XXXXXXXXXXXXXXXXXXXXXXXX-XXXXXXXXXXXXXXXX----XXXXXXXXXXX-XXXXXXXXXXXXXXXXXXXXXXXXXXXXXXXX
