------------------E---E----------------B------------------XB-----------------X--------------------------------------------------B---------------------------------------------------B------------------B
--E-------E------B-----------------------------------B----------------------------------------------------------------M-----------------------------------------ET-----------------------------------B-E
----B------------------------B-----------------B------B-----------------------------------------------------------------------------------------B|--------B------|---|------------------------------E---
o--------E------------BB------------------B------EB------------------------------------------B-------------------------------B-------------------|---------------|-----------------------------T--------
------EB-----------------T----------------E--B----------------E---------------------------------------------------------------------------------B|---------------|-----------------------------|--------
----------T-----------E--|------T--------------------------------B-B------------------------B----E---------------B-------------------------------|---------E-----|--------------------------|--|--------
----------|-------T------|------|-------T-----------------B-------------------------------------------B------------------------------------------|-T-------------|-----------------------------|-------B
---B------|-------|------|--B---|-------|-------------------T--------B------------T---T-----------------------------M--------E-------E---------------------------|-------B--B--------B--------E--------v
o-----T---|----B--|-------------|-------|------------T------|----------E----------|---|------------------|----------------------EB---------------|--------E------|--------B-----------------------------
E-----|---|-------|-------------|-------|------------|--------------------------------|---T----------B---|--B------------------------------------|-------------E-|-------------------------------------?
----B-|---|---------------------|----B-------B--------------------------------B--------E---B------B-----B|------|-------------------------------------------------------------------------------T------B
?-----|---|-BE-------------------------E--------------T------|-E---E-------------------------------T---------------------|-----B-----------------------B----------------------------------------|-------
------|---|--------------|----------------------------|------|--------------------B----------------|------------|--------|-----------------------|----------|-----------------------B-----|--B--|-----B-
o-----|-E-||------------------------------------------|-------------B-----------------------|------------|------|--------|--------------E------B--|-B--B-------------------------------B--------|------o
m-----|---|----BT---B----|------E--T------------------|---B--|------B----T--|---------------|----------B-----T--|------X-|---M--------------------|----BB---|----------------B------B-----|-----|------?
XXXXXXX--X-X-X-X--XXX----X-X-XXXX----XXX-X-X---X--X-XX-X-X-X-XX--X-XX--X-X--X---X-X-X-XX---X-X---X--X-X--XX-XX----X--XXX-X-X---X--X-X--XX--X---X--X--XXXX-X-------X-X-X-X-XXXX--X-X---XXXXXX--X-X-XXXXXX
