--------------------------------------------------------------------------------------------------------------------------------------------------------------------------------------------------------
------------------o-------------------------------------------------------------------------------------------------------------------------------------------------------------------------------------
----------------o---------------------------------------------------------------------------------------------------------------------------------------------------------------------------------------
----------M---------------------------------------------------------------------------------------------------------------------------------------------------------------------------------------------
--T-------------------T---------------------------------------------------------------------------------------------------------------------------------------------------------------------------------
--|-------------------|--X------------------------------------------------------------------------------------------------------------------------------------------------------------------------------
--|T------------------|-XX------------------------------------------------------------------------------------------------------------------------------------------------------------------------------
--||-----------X------|XXX-----------------------------------------------------------------------------------------------------------------------------------------------------------------------------v
--||----------XX------|XXX-----------------------------------------------------------------------------------------------------------------------------------------------------------------------------f
--||----X----XXX-----X|XXX-------------------------------------------------------------------------?---------------------------------------------------------------------------------------------------f
--||---XX---XXXX----XX|XXX-----------------------------------------------------------------------------------------------------------------------------------------------------------------------------f
--||--XXX--XXXXX---XXX|XXX-----------------------------------------------------------------------------------------------------------------------------------------------------------------------------f
--||-XXXX-TXXXXX--XXXX|XXX-------------?---------------------------------------------------------------------------------------------------------------------------------------------------------------f
--||XXXXXX|XXXXX-XXXXX|XXX-----------------------------------------------------------------------------------------------------------------------------------------------------------------------------f
m-||XXXXXX|XXXXXXXXXXX|XXX-----------------------------------------------------------------------------------------------------------------------------------------------------------------------------X
XX||XXXXXX|XXXXXXXXXXX|XXXXXXXXXXXXXXXXXXXXXXXXXXXXXXXXXXXXXXXXXXXXXXXXXXXXXXXXXXXXXXXXXXXXXXXXXXXXXXXXXXXXXXXXXXXXXXXXXXXXXXXXXXXXXXXXXXXXXXXXXXXXXXXXXXXXXXXXXXXXXXXXXXXXXXXXXXXXXXXXXXXXXXXXXXXXXXXXX
