-------------------------------------------------------------------------------------------------------------------------------------------------------------------------------------------------------B
--------------------------------------------------------------------------------------------------------------------------------------------------------------------------------------------------------
--------------------------------------------------------------------------------------------------------------------------------------------------------------------------------------------------------
--------------------------------------------------------------------------------------------------------------------------------------------------------------------------------------------------------
--------------------------------------------------------------------------------------------------------------------------------------------------------------------------------------------------------
-------------------------------------------------------------------------------------------------------------------------------------------------------------------------------------------------------X
--T------------------------------------------------------E----------------T-X--------X---E--X-----------T--------------?B------------------------E---X-----------XXXX---------------E-------------------
----------------------------------------------MB?B?---X--XX---X-------------E-XT-X---------o-ooo------------E--------------------------------B?B?--BXXX----E-------------------------------------------v
-----------------------------------------XX---------------XXXXX----M------------E--BMB---XX----o-----B-B?----------E------E--------------------------------E---B-B-----------o----------EB----B--?B----f
--XX-----------M--------oooooXX-------------B-----------E-------------------------------------XXXX-BM?-------o--------------------oooo----------oooT-----------T--XT-----------T-X---T--XEXX--X----XX--f
----?---------------XX-XXX-XXX--------E--------------------------E--?---------X-----E----MB--------------E-------------------?B------oT------X----B-------------------T-o------M------XX-?B?---o----XX-f
-------o----ooooX-XXXX----XXX------------------XXX-----E-----------------------E-----------------------XXX----------------------X-----|--XXXX---|----?B?B-------X---XXX----XX-----------X-XT-----T-----f
-----o----E--E--------------------------o------------X--X-----XXX-----XXXT-|----------BT---ooo----------XX------?B?-?B?--E----------XX|---E-----|----X--X-X------?B?B-|--X---------------T-|-----|---X-f
----E---------------E---B-B?B---E-XT-X----XXX--E-X-X--X-X------?-XT------|-|-E-X------X|----T-M----B?------?-------EXXX------------M-M|---------|--XXX---X|XXX--------|----------XXX-----|-|-----|-----f
mXT-M--------------X---------------|-------------E--------E-------|--o---|-|-E-|-oooo--|----|----------------B-B---XX----XXXX---------|---------|-----XXXX|-----------|-XXXXXXX-X-XX-X---|-|-----|-----X
XXXXXXXXXXXXXXXXXXXXXXXXXXXXXXXXXXXXXXXXXXX--XXXXXXXXXXXXXXXXXXXXXXX-XXXXXXXXXXXXXXXXXXXXXXXXXXXXXXXXXXXXXXXXX-XXXXXXXXXXXXXXXXXXXXXXXXXXXXXXXXXXXXXXXXXXXXXXXXXXXXXXXXXXXXXXXXXXXXXXXXXXXXXXXXXXXXXXXXX
