-------------------------------------------------------------------------------o-----------------------------------------X-----------------------------------------------o------------------------------
---------------------------------------------------------------B----------------------------------------------------------------------------------------------------------------------------------------
---------------------------------------------------------------------------------------------------------------------------------------------------------------------------------------------X----------
-------------------------------------------------------------------------------X------------------------------------------------------------------------------------------------------------------------
-------------------------------------------------------------------------------X----------X----------------------------------------------------------------------------------------?-------------B------
--------------------------------------------T--------------------------------------------XX-???o???-----------------------------------------------------------------------------------------------------
-----------------------------T--------------|-------------------------------------------XXX------------------------------------------------------------------------------------------B------------------
-----------------------------|--------------|----------------------------------------XXXXXX------------------------------------------------------------------------------------------------------------v
-----------------------------|--------------|-----------------------------------------XXXXX------------------------------------------------------------------------------------------------------------f
-----------------------------|------T-------|-----T-------T--------------------------XXXXXX------------------------------------------------------------------------?-----------------------------------f
-----------------------------|------|-------|-----|-------|-------------------------XXXXXXX------------------------------------------------------------------------------------------------------------f
-----------------------------|------|-------|-----|-------|------------------------XXXXXXXX------------------------------------------------------------------------------------------------------------f
-----------------------------|------|-------|-----|------?|-----------------------XXXXXXXXX------------------------------------------------------------------------------------------------------------f
-----------------------------|------|-------|-----|-----T-|-----------------T----XXXXXXXXXX------------------------------------------------------------------------------------------------------------f
m----------------------------|------|-------|-----|-----|-|-----------------|-E-XXXXXXXXXXX-------------------------------------------------E---------------------------------------E------------------X
X----XXXXXXXXXXXXXXXXXXXXXXXX|XXXXXX|XXXXXXX|-----|XXXXX|X|XXXXXXXXXXXXXXXXX|XXXXXXXXXXXXXXXXXXXXXXXXXXXXXXXXXXXXXXXXXXXXXXXXXXXXXXXXXXXXXXXXXXXXXXXXXXXXXXXXXXXXXXXXXXXXXXXXXXXXXXXXXXXXXXXXXXXXXXXXXXX
