-------------------------------------------------------------------------------------------------------------------------------------------------------------------------------------------------------B
--------------------------------------------------------------------------------------------------------------------------------------------------------------------------------------------------------
--------------------------------------------------------------------------------------------------------------------------------------------------------------------------------------------------------
--------------------------------------------------------------------------------------------------------------------------------------------------------------------------------------------------------
--------------------------------------------------------------------------------------------------------------------------------------------------------------------------------------------------------
-------------------------------------------------------------------------------------------------------------------------------------------------------------------------------------------------------X
--T------------------------------------------------------E----------------T-X--------X---E--X-----------T--------------?B------------------------E---X-----------XXXX---------------E-------------------
----------------------------------------------MB?B?---X--X----X-------------E-XT-X---------o-ooo------------E--------------------------------B?B?--BXXX----E-------------------------------------------v
-----------------------------------------XX---------------XXX-X----M------------E--BMB----X----o-----B-B?----------E------E--------------------------------E---B-B-----------o----------EB----B--?B----f
--XX----------B?B?------ooooXXX-------------------------E------------------------------------X-XXX-B??-------o--------------------oooo----------o-oT-----------T--XT-----------T-X---T--XEXX--X----XX--f
----?---------X-----XX-XXX--XX--------E--------------------------E--?---------X-----E----MB--------------E--------------------B------oT------X---MB-------------------T-o------M------XX-?B?---o----XX-f
-------o----ooooo-XXXX----XXX------------------XXX-----E--------------------M--E-----------------------XXX---------------X------------|--XXX----|----?B?B-------X----X|----XX-----------X-XT-----T-----f
-----o----E--E--------------------------o------------X--X-----XXXX--X--XXT-|----------BT---ooo----------XX------?B?-?BM--E----------XX|---E-----|---XXX-X-X------?B?B-|--XX--------------T-|-----|---X-f
----E---------------E---B-B?B?--E-XT-X----XXX--E-X-X--X-X------?-XT------|-|-E-X------X|----T-M----B?------?-------E-XX--------------M|---------|-XXXX---X|XXX--------|----------XXX-----|-|-----|-----f
mXT-M--------------X---------------|-------------E--------E-------|--o---|-|-E-|-ooo?--|----|----------------B-B---XX----XXXX---------|---------|-----XXXX|-----------|---XXXXX-X--X-X---|-|-----|-----X
XXXXXXXXXXXXXXXXXXXXXXXXXXXXXXXXXXXXXXXXXXX--XXXXXXXXXXXXXXXXXXXXXXX-XXXXXXXXXXXXXXXXXXXXXXXXXXXXXXXXXXXXXXXXX-XXXXXXXXXXXXXXXXXXXXXXXXXXXXXXXXXXXXXXXXXXXXXXXXXXXXXXXXXXXXXXXXXXXXXXXXXXXXXXXXXXXXXXXXX
