----------------------------------------------------------------------------------------E---------B-E------------------------B-B--------------B-------B---------------------B------------------------T--
-------E------BT--------------------------------T--------------B------------------------------B--------------B---------------------------E-----------------------E--------------------------------------
-------B-----T------------------------------------------------------------------B------T-----------------------B-------------T------?----------B--------------------------------------------------------
B-------E------------------------------------B------------------------------B----------------B----------------------------B---------------E------------B---------B-------------------B------------------
------------T----------------------------------------------------------EB----------------------------B--------------------------------B---E--X--E---------E---B----E----------------B-------------------
--------------------------------------B-E-----E-----T---------------T----------------B---------------------B-----------B-B---------E----------------------------------B--B------------------T-T---------
--------E------B--E--------TE-------B---------------------------B-------------------------------------------------B-------M---------B-T-----------------------------------------------------------------
----------------------------------------------------------------B--------------------B----T-----E-------------E-----------------o-------------------------B----------------------B------------------B--v
-----------------B-------------------------------------------------T-----B--------------B--B-------------------------------------------------B-------------------------------------E--------------------
----------T-----B----------------------------------B-----------------------------E-----T------E------------------T--------------------------------E-------------|--------------E------------------------
----------|--------------B--------------------B-----B------B-E-----|-----------------------------------------------------------E----------------B----E---|------|-------------------E-------------------
-----BB---|---B----------------------------------------------------|-------------------------------------E-B----T------------------------------------------B-------------------------------------E----B-
----------|-----------------E-----------------E--------------B-------------------------|----------E-----T-------||-B--------B--------|-----------B-------|------------------------------BB---E----------
----------|--B-E---------E--------------E------E------------------T|----------------------------B---------------|------------------B-|------------------------------T-----B-----------------------------
m---------|--B---------------------------------------B--------B---||--------T--B-------|----------E-----|-------|----------------B---|-------------------|------|---------------------------------------
X-XXXXXXX--XX-X-X----XXXX--X-X-X-XXXX-XX--X---XX-X-X----XXXX-XX-X-XX--X--XXX-XX----X-X-X--XXXX--X---X-XXXX---X-----X-XX--XXXX-X--X-X--X-XX--X--X-X----XX-XXX--X-XX--------X--X--X-XX----X---XXX---XXXXXX
