--------------------------------------------------------------------------o--------------------------------B--------------------------------------------------------------------------------------------
--------------------------------------------------------------------------------------------------------------------------------------------------------------------------------------------------------
--------------------------------------------------------------------------------------------------------------------------------------------------------------------------------------------------------
------------------------------------------------------------------------------------o-------------------------------------------------------------------------------------------------------------------
-------------------------------------------------------------------------------?------------------------------------------------------------------------------------------------------------------------
--------------------------------------------------------------------------------------------------------------------------------------------------------------------------------------------------------
--------------------------------------------------------------------------------------------------------------------------------------------------------------------------------------------------------
----------------------------------------------------------------?------------------------------------------------------------------------------------------------------------------------------------o-v
-------------------------------------------------------------B----BB-----------------------------------------------------------------------------------------------------------------------------------f
---------------------------------------------------------------?----M-----?----------------------------------------------------------------------------------------------------------------------------f
-------------------------------------------------------------------------?-----------------------------------------------------------------------------------------------------------------------------f
--------------------------------------------------------T---------T-----o------------------------------------------------------------------------------------------------------------------------------f
--------------------------------------------------------|-------X-|-------X------------------------------------------------------X---------------------------------------------------------------------f
--------------------------------------------------------|------XXX|---X--XXT---BBBB-----------------T------------------X--------XX-------------------------------------------------------------------o-f
m-------------------------------------------------------|--E-EXXXX|--XX-XXX|------------------------|-----------------XX-------XXX-------------------------------------------E-------------------------X
XXXXXXXXXXXXXXXXXXXXXXXXXXXXXXXXXXXXXXXXXXXXXXXXXXXXXXX-|-XXXXXXXX|XXXXXXXX|XXXXX---------XXXXXXXXXX|XXXXXXXXXXXXXXXXXXXXXXXXXXXXXXXXXXXXXXXXXXXXXXXXXXXXXXXXXXXXXXXXXXXXXXXXXXXXXXXXXXXXXXXXXXXXX-----X
