-----------------------------------------E------------------------E-------------M----------------------------------------------------------------------------------------------------------------------X
-------B---------------------------------------------B---------------E----------------------------------------------------------------------------X-----------------------------------?---B------------M
-----------------------E-B----------------T------------------------------------------T-------?---------------------------------B-------------------E----------------------------X----------------------o
------E--------------------------------B-T---------------------------------------T----M---------X---------------B--------------------------------------------B----B----?-------------------------------B
-------BB-------------------T----T-------------------T--EB---------------------------------------------------------------B------------------------------------------------------------------------------
----E------------B----------|----|-----------------EX|----T-----------------B-----------------------------------------------------------E--------------T-----------------X-----------------------------X
---------------------------T|-------------------E----|--ET|-------B------------------------------T-----------------T------------------------------------------------B----B------------------------B-----
-----E-----------E----------|----|-------------------|---|----B------------------------------------------------------------------------------------------B--------------------------------------------Bv
----------------------------------------------------------|-B-------B----E------------X----------------------|-----|-----------------------------------|--E--B------------------T-----------------------
----------------------------|------------E-----------|---||----E-----------------------------------------------------------------------|-------B---------B-------------B--------------------------------
-------------|-----------BT|----------------------B--|----|-B----E-----------?----------------E--?---E-------------|-------------------|---------------|----------------B------------B------------------
-------------|-|---------T|||-------------E----|---------||--------------------------------------|X---B------|-----|-----------B-------|---B--------------------------E---------|---B-------------------
-------------|--------------|------------------|-----|---||----------------------------------B---|-----------------|-------------E-------------------B------B------------------------------B--B---------
o--------------|--E------||-|----|----------------E--|----|-------------------------B---------B--------------|-----------------------------B------------------------------------|-B-----------------E---
m--------------|---------|--|------------------|---E-|----|---T---------B---------------------B-B-------E----------|----B|---------------------------------------------E---B--B-|------T-------B-B------
X-XXXXXXXX-X-XXX-XXXXXX-XXX-X--X-X---X-XX-X----X--XX-XX-X-XXXXXX-XX-XX-X-X-------XXX-X---XXXX---X--XX-XX-XX--XX-X-XX---X--X--XXX---X---X-XXX-----X-----XXXXX--X--XX--XXXXX-XX--XXX----X-X---X-X-XXXXXXXX
