--------------------------------------------------------------------------------------------------------------------------------------------------------------------------------------------------------
--------------------------------------------------------------------------B-o------------------------------------------------------------------------------------------?--Xo----------------------------
---------------------------------------------------------------------------------------------------------------------------------??------------------------------------------------------------------XX-
-----------------------------------------------T---------------------------------------X-------------------------------------------------------------------------------------------------------X--------
-----------------------------------------------|------------------X--------T----------T--------------------------------------------------------------------------------------------------------------B--
--------?--------------------------------------|-----------------XX--------|???-------|--------------------X-------------------------------------X------------------------------------------------------
----------------------------o------------------|----------------XXX--X-----|----------|--------------------XX--------------------------------------------------X----------------------------------------
-----------------------------------------------|BBBBBB---------XXXX--XX----|----------|--------------------XXX---------------------------------------------o-------------------------------------------v
--T----------------------X---------------------|----T---------XXXXX--XXX---|----------|--------------------XXXX--------------------------------------------BBBBBB--XXXXX------------------------o------f
--|--------------------------------------------|----|-X------XXXXXX-XXXXX--|----------|--------------------XXXXX---------------------------------------------------------------------------------------f
--|--------------------XXX---------------------|-X--|-XX----XXXXXXX--XXXXX-|----------|-------X------------XXXXXX--------------------------------------------------------------------------------------f
--|--------------------------o-----------------|----|-XXX--XXXXXXXX--XXXXXX|-------X--|--------------------XXXXXXX--------------------------------------------------------T----------------------------f
--|--------------------------------------------|----|-XXXXXXXXXXXXX--XXXXXX|-------XX-|--------------------XXXXXXXX-------------------------------------------------------|----------------------------f
-B|--------------------------------------------|----|-XXXXXXXXXXXXX--XXXXXX|X------XXX|--------------------XXXXXXXXX------------------------------------------------------|----------------------------f
m-|---------------------XXX--------------------|----|-XXXXXXXXXXXXX--XXXXXX|XX-----XXX|-----E--------E-----XXXXXXXXXX---------E-------XXXXXXXX----------------------------|----------------------------X
XX|XXXXXXXXXXXXXXXXX----------XXXXXXXXXXXXXXXXX|XXXX|XXXXXXXXXXXXXX--XXXXXX|XXXXXXXXXX|XXXXXXXXXXXXXXXXXXXXXXXXXXXXXXXXXXXXXXXXXXXXXXXXXXXXXXXXXXX????XXXXXXXXXXXXX-------|---XXXXXXXXXX---XXXoXXXXXXXXX
