-----------------------------------------------------------------------------------------------------------------------------------------------------------------------------------------------------T--
--------------------------------------------------------------------------------------------------------------------------------------------------------------------------------------------------------
--------------------------------------------------------------------------------------------------------------------------------------------------------------------------------------------------------
-------------------------------------------------------------------------------------------------------------------------------------------------------------------------------------------------------X
--------------------------------------------------------------------------------------------------------------------------------------------------------------------------------------------------------
-------------------------------------------------------------------------------------------------------------------------------------------------------------------------------------------------------?
---E--------------EE---------------B------E---------------?-?----------X-X---XXXXX----T----------E-Mooo-XXX-?B-XX-X--XXX----------------------------T-X---M-M---X-----XT-X-XXXXX---XX--------XX-XX----EX
------------------------------?-----------------------------X-XXX------------------------T----------?B?--B--XXX--------EXXX---------------?---B?B?B?BXX------o-XXXX-----X---?-?B?XXXX-oooT-----XXX-----v
--E------------XX-------------o-------------------------XXXX-------XXX----------M-E--E-E--------o-o---------B------X------------------E-------------E----XX--------T-------?TE-E-------B?B--X---X----E-f
------B--MB-------X-X---?--TE---B?-------------T-X----------o-o-----XX-X--X---E-B-B?B?-----------------E----T----EX?---------E------B-B?---------T-o---Moo-o----XXXX-MB--------XX-X--------M--B----X--Xf
------------X---------E-----X--------X-------MT-X----X--oT-XX-------MBoo-------T--?---X----------?-X----ooo----------X--M------------?E---X--T---XX----------M--XX----E-T-----M----X--XXXXXXX--X--oXXX-f
-------|--------------------------------------|---E------|XXXX-----E---XXX-----|-------------TTXX----?B?M-----?B?B----B?B?---?-----------X---X----XXTEX------o----------|--ooo------T-B-----X-XX?B?E---f
----X--|--------------XXX----T-o-oB-B---------|----------XXX----E----|B?---------------ooooo-||-----?B?-?-------------------o-o---------EXX-X|-----E|-?-E-------B----M--|-----------|--B--------B-B?B--f
-------|------X-XX-----------|-------XT------?-------T---|------B--?-|--E------|-------------||-----------------X-----------XX-------------?-|XXXXT-|---X--------------E|----------T|--T-XXXX-------M--f
m------|--------------E------|--------|--------------|---|-----------|---------|----BMB-XTT--||---oo-oo-o------XXXXXXX------XXX-----------o--|----|-|------------------XXX---------|---|--T--T----X----X
XXXXXXXXXXXXXXXXXXXXXXXXXXXXXXXXXXXXXXXXXXXXXXXXXXXXXXXXXXXXXXXXXXXXXXXXXXXXXXXXXXXXX-XXXXXXXXXXXXXXXXXXXXXXXXXXXXXXXXXXXXXXXXXXXXXXXXXXXXXXXXXXXXXXXXXXXXXXXX-XXXXXXXXXXXXXXXXXXXXXXXXXXXXXXXXXXXXXXXXX
