------T------------------------T-----B---E---------------E-B------B---------------B---------------------E------------------------------------------------EB---------B---------E-------------E-----------
-------------------------------------------------------------------------B------------EE-------M-------------------------------------------------ET-----------------------------T----T----------------T-
------------------------------------------B-------------------------------------------------------------------------?----------------------T------------------------B--------------------------------B--
-----------------B---------------------------------------E----------------------------------------------------------------------------------------------------------B---E-------------------------------
o------------------------------------------------------------------------------B------------------E-------------------------------T---E-------------B---------------------------------------------------
---------B--------------------------------------------------------------------------------------------B-----------------------------------------------------------------------------------T---B---------
-----B---------------------------------------------------------------------------BB----------E------------------------B----------------------------------B-----------------------------------B----------
-----B--B--T----------------------B-------------------E----------------------------------B----------E----B------------------------------------M-----E----T------T-------------------------------T------v
---B------------B-------------------------T-------------B-------------------------T----------------E------------------o---------------------------------------------------------------------------------
o----------------------------B---------E--|----------------------------------X----|--------B--------------------------------B----E-----------------------------------------------------T-T-B----T-E-TE--
X---------------------------------B--------------------------|--------------------|------------------------------------------------------------------------------------------------------|-B-|--|---|---
B---------------------------B-------------|--B------------------B-----------------|-----------B--B----------------------------E----------E---------------------------|---B---------B---|-|---|--|---|---
-------E--------B-------------------------|--------B---------------------------T--|------------B-------------B--E----|-------T-----------------------E---------B-----|-----------------|-|---|--|---|-B-
B--B----------------------------------T---|----------EB------------------------|--|---B-----B-B---------|-----B------|-------|--------------B----------------------E-|-----------B-B---|-----|---------M
m--------E---------------B----------------|----T-------------------|---------B-|------------------------------BB--------B----|--------------B--B---------------------|-----------T-----|-|---|--|-T|----
X-XXXXX-XX---XX--X------X-XX--XXXX---------X-XXX-XXX-XXX--XX---XX----XXXXX---X-------X--X--XX-----X----X---XXX------X-XX-X------X-X---XXXX---XXX-XX---X-X-X------XX----XX-----X-XX--X---XX--XXX-XXXXXXXX
