--------------------------------------------------------------------------------------------------------------------------------------------------------------------------------------------------------
-------------------------------------------------------------------------------------------------------------------------------------------------------------------------------------------------------X
-------------------------------------------------------------------------------------------------------------------------------------------------------------------------------------------------------X
-------------------------------------------------------------------------------------------------------------------------------------------------------------------------------------------------------X
-------------------------------------------------------------------------------------------------------------------------------------------------------------------------------------------------------X
-------------------------------------------------------------------------------------------------------------------------------------------------------------------------------------------------------o
---------------------------E------E-----------------------------E---------------------------------------------------?B?BMB------------------E------------------------------------------------X----------
--------------------------------E-------------------B-B---E------------------------------------------------------------------------------?-?B--M-E----------------------------------------T------------v
----------------XXXX-----o-oooo------XXX--X-----X---------------E--M------X------BMB---T---------------BT-X---X?-MB-----XXXX-B?--------E---------------?--B-E-------X-Xooo-E-----E--B-B-----E--E--X-X--f
---------------Eoo--o--XX----?------------------?------XXX----X--XX-XXXo-ooo--------E-------oT---XXXX--------B?BXXX-XT---------XT----T-XXX-----ooo----XE----------E----XXX-o-oo-E--?T--XX----X-X-------f
--T-X----XT------E------X----------------------------E-------XXE?-----------X----------E-?B?-M-XX-------------B?B--M-?TEB-X-XX--XXX--XXX---oo--oo------MMT-X---------B?B?-------B?B------TT-XXX-XX-X-T-f
--|--?T-B-|--------------E---E--E-------X---------XXX---E-----------XXXX--E-------XXXXX-----ooo-----------------E-----|--X---E------X---------X---E---XT-|------?BX-X-------------XT-X---||----------|-f
---B?B|---|--E----------------------------------|--------?-?B?BBM-?----E------XX---XX---M---------XX----------------X-|-T-E--?-MB?-M----------o--------|-|---B--M------X---XXX--|--|-----||--M-----o---f
------|--------------E-----B-------------E------|-?-?B?XXX-oo--o---o--------------------------------------------------|-|------------------------------|-X------------B|?XXXX-X-|--|---E-||----------|-f
m-|---|-----?-------ooo-----ooo-----------------|-------------------E------E-----E--------E---oo-------B--BMB?-MB-----|-|------X-----------------X-----|-|-XXXX--------|--X--X--|--|-XX--X|----------|-X
XXXXXXXXXXXXXXXXXXXXXXXXXXXXXXXXXXXXXXXXXXXXXX-XXXXXXXXXXXXXXXXXXXXXXXXXXXXXXXXXXXXXXXXXXXXXXXXXXXXXXXXXXXXXXXX-XXXXXXXXXXXXXXXXXXXXXXXXXXXXXXXXXXXXXXXXXXXXXXXXXXXXXXXXXXXXXXXXXXXXXXXX-XXXXXXXXXXXXXXX
