-----------------------------------------------------------------------------------------------------------------------------------------------------------------------------------------------------T--
--------------------------------------------------------------------------------------------------------------------------------------------------------------------------------------------------------
--------------------------------------------------------------------------------------------------------------------------------------------------------------------------------------------------------
-------------------------------------------------------------------------------------------------------------------------------------------------------------------------------------------------------X
--------------------------------------------------------------------------------------------------------------------------------------------------------------------------------------------------------
-------------------------------------------------------------------------------------------------------------------------------------------------------------------------------------------------------?
---E--------------EE---------------B------E---------------?-?----------X-X---XXXXX----T----------E-MoooXXXX-?B--X-X--XXX----------------------------T-X---M-M---X-----XT-X-XXXXX---XX--------XXXXX----EX
------------------------------?-----------------------------X-XXX------------------------T----------?B?--B--XXX--------EXXX-X-------------?---B?B?B?BXX------o-XXXX-----X--X?-?B?XXX--oooT-----XXX-----v
--E------------XX-------------o-------------------------XX---------XXX----------M-E--E-E--------o-o--------MB-B--X-X------------------E-------------E---XXX--------T-------?TE-E--------?B--X---X----E-f
------B--MB-------X-X---?--TE---B?B------------T-X----------o-o-----XX-X--X---E?B--?B?-----------------E----T----EX?---------E------B-B?---------T-o---M---o----XXXX-MB--------XX-X--------M--B----X--Xf
-----------XXX--------E-----X--------X-------MT-X----X--oT-XX-------MBoo-------T--?---X----------?-X----ooo------M---X--M---o--------?E---X--T---XX----------M---X----E-T-----M----X--XXXXXXX-----oX---f
-------|--------------------------------------|---E------|XXXX-----E---XXX-----|-------------TTXX----?BBMB----?B?B----B?B?---?-----------X---X----XXTEX------o----------|--ooo------T-B-----X-XX?B?E---f
----X--|--------------XXX----T-o-oB-B---------|----------XX-----E----|B?---------------ooooo-||-----?B?B--------------------ooo---------EXXXX|-----E|-?-E-------B----M--|-----------|--B--------B?B?B--f
-------|------X-XXX----------|-------XT------?-------T---|------B--?-|--E------|-------------||-----------------X-----------XX-------------?-|XXXXT-|---X--------------E|----------T|--T-XXXX-------M--f
m------|--------------E------|--------|--------------|---|-----------|---------|----BMB-XTT--||--oooooooo------XXXXXXX------XXX-----------o--|----|-|------------------XXX---------|---|--T--T----X----X
XXXXXXXXXXXXXXXXXXXXXXXXXXX-XXXXXXXXXXXXXXXXXXXXXXXXXXXX-XXXXXXXXXXXXXXXXXXXXXXXXX-XX-XXXXXXXXXXXXXXXXXXXXXXXXXXXXXXXXXXXXXXXXXXXXXXXXXXXXXXXXXXXXXXXXXXXXXXXX-XXXXXXXXXXXXXXXXXXXXXXXXXXXXXXXXXXXXXXXXX
