--------------------------------------------------------------------------------------------------------------------------------------------------------------------------------------------------------
--------------------------------------------------------------------------------------------------------------------------------------------------------------------------------------------------------
--------------------------------------------------------------------------------------------------------------------------------------------------------------------------------------------------------
--------------------------------------------------------------------------------------------------------------------------------------------------------------------------------------------------------
--------------------------------------------------------------------------------------------------------------------------------------------------------------------------------------------------------
---?----------------------------------------------------------------------------------------------------------------------------------------------------------------------------------------------------
---------------------------------------------------------------------------------------------------------------------------------X----------------------------------------------------------------------
----T--------------------------------------------------------------------------------------------------------------------------------------------------------------------------------------------------v
-X--|--------------------------------------------------------------------------------------------------------------------------------------------------------------------------------------------------f
-XXX|XXX-------------------------------------------------------------X---------------------------------------------------------------------------------------------------------------------------------f
----|----------------------------------------------------------------XX--------------------------------------------------------------------------------------------------------------------------------f
----|----------------------------------------------------------------XXX-------------------------------------------------------------X--X--------------------------------------------------------------f
----|----------------------------------------------------------------XXXX------------------------------------------------------------------------------------------------------------------------------f
----|XX--------------------------------------------------------------XXXXX-----------------------------------------------------------------------------------------------------------------------------f
m---|----------------------------------------------------------------XXXXXX----------------------------------------------------------------------------------------------------------------------------X
XXXX|XXXXXXXXXXXXXXXXXXXXXXXXXXXXXXXXXXXXXXXXXXXXXXXXXXXXXXXXXXXXXXXXXXXXXXXXXXXXXXXXXXXXXXXXXXXXXXXXXXXXXXXXXXXXXXXXXXXXXXXXXXXXXXXXXXXXXXXXXXXXXXXXXXXXXXXXXXXXXXXXXXXXXXXXXXXXXXXXXXXXXXXXXXXXXXXXXXX
