---B------------------X-----------X-------X------BB------------------X------------------B---------------------------------------------------B------------------B---------------------XB----B---------B--
--E-B------------------X--B-------------------------B------------B------------------------------------B--------B----B-------------------------------------B-------------------------------------BB-B---?
------------------------B---B------X-----------B-X--------------------B------B-------B----B--B-------------------------------BB------E--B------------------B--B---B-B--BX------BB--B--B-------------B--?
-----------------B--B--B--B----------------------BB-BB------B---B-------B---------------------------BB---------B---------E---X------X--B-------------------X----B---B--B---B--------------X-------------
B-E--X-----------B-------------B--------B-------------------X---B-----------------------B--------B-B-----X--B-------B-------------------------B------------XBB----X--------------B----B----B-B----------
B-B---------------B-----E---X--------X-----------------------X--------X--------------B---E----X---B---------B--------------XB----B----------------------------XB-B-E-X-----------------------BBB--------
--------------------B--------EX--------BB-----------X---E-------------BX--B-----B-------X------B----------------B--B-------------------X---B--------B---------E-----BB---B------BB-X--X---X-----------X-
E-----------------B-----------B----BB-B---B---B----X----------X--X---------------------BB----X---B----B---------------------------------------------------B------B----------------------------B--------v
-----------B----E------E-B---X------------B-----------------B--------B------B---------X------------------------B-----------------------E-----------BX--------X---------------------------X-----B-------M
-------------BB----X----------------------B------------------B------------B-XX----EB---X----B---------E------B---B-------------------------B-----------------X-B-------X-------B--------------------B-B?
-X---------------------B---------------------------------------------------B---B------------------------------B------------------B---B--B-------------------B-------------------X------B-------B----BX--
o-----B------------------B----X--B------------------E---B-B-----------------E------X--------EX-----X--------B------BE----------B--B----------B--B-B--BB----------B-------------B---------X-----XB-B-----
E-----X----BBX---B--B------B--B----E----------------BXB--B--B-------------B---------B-X-----XB---B-----X--------------X---E----------------------B---------E-------------X-----XB-B--X-B---------X-----?
--------------------X---------X--X-----X------------------------------------------------B----X-----E--E--------------X----B---------------------------------------B----B---B---------B--X------X--------
m-----B---B--------------------B---E---------E-----------------E-B-------X------------B--B------B----------------B-------B----B--E------------B---BBX------B-------X--------B---------------------------
XXXXXXXXXXXXXXXXXXXXXXXXXXXXXXXXXXXXXXXXXXXXXXXXXXXXXXXXXXXXXXXXXXXXXXXXXXXXXXXXXXXXXXXXXXXXXXXXXXXXXXXXXXXXXXXXXXXXXXXXXXXXXXXXXXXXXXXXXXXXXXXXXXXXXXXXXXXXXXXXXXXXXXXXXXXXXXXXXXXXXXXXXXXXXXXXXXXXXXXX
