--------------------------------------------------------------------------------------B-----------------------------------------------------------------------------------------------------------------
----------o-----------------------------------------------------------------------------------------------------------------------------------------???-------------------------------------------------
-------------------------------------------------------------------------------------------------------------?--------------------------------------------------B---------------------------------------
-------------------------------------------------------------------------------------------------------------------------------------------------------------------------------------------T------------
------------?---------------------------------------??-------------------------------------------------------------------------------------------------------------------------------------|------------
-------------------------------------------------------------------------------X-----------------------------------------------------------------------------------------------------------|------------
-------------------------------------------------------------------------------XX----?-------------------------------------------------T---------------------------------------------------|------------
-----------------------------------X----------------------B--------------------XXX-----------------------------------------------------|---------------------------------------------------|-----------v
----------------------------------XX-------------------------------------------XXXX--?-------------------------------------------------|---------------------------------------------------|-----------f
---------------------------------XXX-------------------------------------------XXXXX---------------------------------------BBB---------|-------------------------------------------B-------|-----------f
-----------X--------------------XXXX-------------------------------------------XXXXXX--------------------------------------------------|---------------------------------------------------|-----------f
-T-----------------------------XXXXX------------------------------------o------XXXXXXXXXXXXX-------------------------------------------|---------------------------------------------------|-----------f
-|----------------------------XXXXXX-------------------------------------------XXXXXXXX------------------------------------------------|------------------------------o--------------------|----T------f
-|---X-----------------------XXXXXXX-------------------------------------------XXXXXXXXX-----------------------------------------------|---------------------------------------------------|----|--B---f
m|--XX-----E----------------XXXXXXXX-------------------------------------------XXXXXXXXXX------------------------------X---------------|---------------------------------------------------|----|------X
X|XXXXXXXXXXXXXX-------XXXXXXXXXXXXXXXXXXXXXXXXXXXXXXXXXXX----------------XXXXXXXXXXXXXXXXXXMXXXXXXXXXXXXXMXXXXXXXXXXXXXXXXXXXXXXXXXXXX|XXXXXXXXXXXXXXXXXXXXXXXXXXXXXXXXXXXXXXXXXXXXXXXXXXX|XXXX|XXXXXXX
