---X----------B------------------------B--X-------B-BB------------------------------------B-X--------------------------BXXXB---------------------------------------------------------------EB-----------
---B--------------------------BX----B-------X------X-----B--B-----B--B----E--B-X-MB-----------------------------------------------------BX-------------BB-B------B-B-------------------------B-------E--
--B------B------X-----X------X---------B----E---------XB----------B---------B---------XB-----X----------X----X--E----------------------B---------------------------X---X------X-------------------------
----------B---B------------E---------B-------------X-----------B--B-B--------E------BB--X------X-------B---B-------------B--X---X--------------?----------B-----E------B-X---------------------X-X------
-----B--X-B-------------------------------------------X--------------X----B----X------------------X----------------E--------------------B--B--------X-------------X------B-----B-----------B------B-----
----BX---B----------------X-E---X--X--------------------------------B---B-------B------------BB-----------------------------------B----------B----------------B-B------B----------------B-------X--E----
--B------B--B-----------------E-----------------------E--B-----X-------X----B-----------------------X---B-B----B--EB----B------------X-----B------------------B---?---B------------B----X---B----------M
---------X---E-X-----B-----------------------------B----B---------------B---B----------E--------------B----------E-------------B-B--B------E-----------BB-----X-------X----E--B---------X------------B-v
o-----------X----------X----------------------B------B-------------X-B--B----E-EBB-------------------------XX-------------E------------------------B---X----------X-----------------------X--X----B-----
--------E----------B----------------B--B----B-------------B---------------B--X-----------BX-----X-B--------B----------X--------------E----------X-XB--------X--X-X--------------X-----------------------
-------X---------B---------------X----BXE--BX---------B-X-----------------------X-X---XX-----------X--X-----BB-X----E-----B------B---EB--B-----------X-----------------------------------------E--------
o-------X---EE---------------B-----------------------------------B--------------B-------EBB--B--------X---B-------------X-------------X-------------------E---------------B---------BB-----B------------
B-----XB-------------BX------------B----------B---------------------------------------B-------------B----------------X-----B-----------------B-----X------X-B------XX-B-------B---------------B--B------
--------------------------B-B--------------------------------------X-XEB--------X-----B--E-----------X--------X--------------------B---------B---B--B-----B------------B-------------------B----------B-
m----E-----------E-------X--B---------B------E--------X----------B-----------------------B-----------------------------------------EB---X----B------X--------B----------------------X-------------------
X--XXXX--XX-X-X--X-X-X-X-XX-XX---X-X-XX-XX-XXX-XX--X-XXXXX---X-X-X-XXXXXXXX--X-XX-X-X-XX-XX-XX-XX-X-XXX-X-X-XXXX-XXX--X-XX-X---X-X-XX--XX--X-X-X-XX-X-XX--X--XXX-X-XXX-XXX--XXX-XX--X--X-X-X-X--X-XXXXXX
