-----------------------------------------E------------------------E------------------------------------------------------------------------------------------------------------------------------------X
-------B---------------------------------------------B---------------E----------------------------------------------------------------------------X---------------------------------------B------------M
-----------------------E-B----------------T------------------------------------------T-----------------------------------------B-------------------E---------------------------------------------------o
------E--------------------------------B-T------------------------------------M--T------------X-----------------B--------------------------------------------B--?-B------------------------------------B
-------BB-------------------T----T-------------------T--EB---------------?-----------------------------------------------B-------------------------------------------------------------?----------------
----E------------B----------|----|-----------------E-|----T-----------------B---------M-------------------------------------------------E--------------T-----------------------------------------------X
---------------------------T|-------------------E----|--ET|-------B------------------------------T-----------------T------------------------------------------------B----B------------------------B-----
-----E-----------E----------|----|-------------------|---|----B------------------------------------------------------------------------------------------B--------------------------------------------Bv
----------------------------------------------------------|-B-------B----E------------X----------------------|-----|-----------------------------------|--E--B------------------T-----------------------
----------------------------|------------E-----------|---||----E-----------------------------------------------------------------------|-------B---------B-------------B----------X---------------------
-------------|-----------BT|----------------------B-X|----|-B----E----------------------------E------E-------------|-------------------|---------------|----------X-----B------------B------------------
-------------|-|---------T|||-------------E----|---------||--------------------------------------|-X-MB------|-----|-----------B-------|---B--------------------------E---------|---B-------------------
-------------|--------------|------------------|-----|---||----------------------------------B---|-----------------|-------------E-------------------B------B------------------------------B--B---------
o--------------|--E------||-|----|----------------E--|----|-------------------------B---------B--------------|-----------------------------B------------------------------------|-B-----------------E---
m--------------|---------|--|------------------|---E-|----|---T---------B---------------------B-B-------E----------|----B|---------------------------------------------E---B--B-|------T-------B-B------
X-XXXXX--X-XX-XX--XX-XXXXXX-X--X---X---X-XXXX-XXX--XXXX---XX-X-X--XX-------XX------X-XX-XXXX--X--X--XXXX-X-X---X---XX--X--XX-X--X-X-X----X-XX-XXX--XX-XX-X--X----XX-X---X--X-X---XXX-X--X--X-X--X-XXXXXX
