---------?---------------------------------------------------------------------------------------------------B---B--E------------------------------------T----X-------B---T-------------------E---------
----------------------------------------------------------B--------------------B-------B------------------------BT----------------------------------------------------------------------------------E--E
--------------------B----B-----------E-------------B--------E-------------------------------------------B-------------B-------B---------------------X-----------------------T---------------------------
------------B-------------T----------------B--------T--------------------------------------E-------------------------B----------B------B----------T-------------------------B---B--------------------E--
-------------BB-B-----B---------X-------------------------------------E-B-------E-------------------------------------------------------B-----------------------------------------------------------E---
-------------------------B--------E----B-----E-----B-----------------------------------------E----------------------------------------------B--|------?----T-------B------------------B-----------------
-----------------E---------------?--------------------------------------------------------------------------------T----------------------------|---------------------------T------------------------B-B-
---------------B------------BTB-B------------------B--B-|---------------------T---------------------|-------B-----|-EB-------------------------|-----------|---------------|------E----|---------------v
-------------B---------------|------B-B--------|--------|---------------------|------?------------B--------T------|--E-------------B---------------------------E-----------------------|--------T---E---
-----------------------?-----|----?------|------------------------?-----------|---------------------|---------B---|---------X---------B-------T|---------------------------|---|-------|--B-----|-------
-----------------------------|-E------------B--|--------|---TE---------------------------------------------|------------B-------------B-------|----------------------------|-E-|-B-----|--B-----|-------
------E-B--BB-----------E----------------------|--------|---|------------------------T------|---E---|------|------|-------T-T-----------------|----------B-|---------------------------|----------------
---B---|----E----------BB-------------T------------B----|---|------B-|--------|---B--------E----BB--|---------------------|-|------------------|--------B--|-E-------------|---|----T-----------------B?
---------------------------E-|--------|------------------------------|-----E--|--B-----------------B-------|------|-------|-|----------------B|--------------------E--------------E----|--B-ET----------
m------|---------------------|--------|-----BE----T-----|--T|-----------------|-------------|-------|------|------|---------|-----B-----------|----------------------B-E--T-------E-|--|--B--|--|--|--E-
X-XXXXXX-X-X---X-XXXXX--X-XXXXX-X--X-XXX-XXXX--XXXXXX--X-X--XX--------X-----XXXXX--XX--X-X-------X--XX--XX--------X-XXXXXX-XX--X---X--X--X-X---XXX-XXXX-X-X----X-X--X-XXX----X---X-XX---XXXX---X--XXXXXX
