------------------------------------------------------------------X---------------------------------------------------------------------------------------------------------BBBBB--------------------?--
------------------------------------------------------------------------------------------------------------------------------------------------------------------------------------------------B-------
------------------------------------------------------------------------------------------------------------------------------------------------------------------------------------------????????------
---------------------------------------------------------------------------------------------------------------------------------------------------------------------------------------------T----------
-----------------------------------------------------------------------------o---------------------------------------------------------------------------------------------------------------|----------
-------------------------------------------------------------X-----------------------------X-----------------------------------T-------------------------------------------------------------|---o------
------------------------------------------------------------XX-----------------------------XX----------------------------------|---------------------------------------------BBB-------------|----------
-----------------------------------------------------------XXX-----------------------------XXX---------------------------------|-------------------------------------------------------------|---------v
----------------------------------------------------------XXXX--------------------------BBBXXXX--------------------------------|------------------------------------------------------------T|---------f
---------------------------------------------------------XXXXX-----------------------------XXXXX-------------------------------|------------------------------------------------------------||---------f
--------------------------------------------------------XXXXXX-----------------------------XXXXXX------------------------------|------------------------------------------------------------||BBBBB----f
-------------------------------------------------------XXXXXXX-----------------------------XXXXXXX-----------------------------|------------------------------------------------------------||---------f
------------------------------------------------------XXXXXXXX-----------------------------XXXXXXXX----------------------------|-----------------------------------------------------???----||---------f
-----------------------------------------------------XXXXXXXXX-----------------------------XXXXXXXXX---------------------------|------------------------------------------------------------||---------f
m--E------------------------------------------------XXXXXXXXXX----------------------E------XXXXXXXXXX--------------------------|---------------------------------------------E--------------||----E----X
XXXXXXXXXXXXXXXXXXXXXXXXXXXXXXXXXXXXXXXXXXXXXXX--XXXXXXXXXXXXXXXXXXXXXXXXXXXXXXXXXXXX---XXXXXXXXXXXXXXXXXXXXXXXXXXXXXXXXXXXXXXX|XXXXXXXXXXXXXXXXXXXXXXXXXXXXXXXXXXXXXXXXXXXXXXXX-----XXXXXXX||XX-XXBXXXX
