--------------------------------------------------------------------------------------------------------------------------------------------------------------------------------------------------------
--------------------------------------------------------------------------------------------------------------------------------------------------------------------------------------------------------
--------------------------------------------------------------------------------------------------------------------------------------------------------------------------------------------------------
--------------------------------------------------------------------------------------------------------------------------------------------------------------------------------------------------------
--------------------------------------------------------------------------------------------------------------------------------------------------------------------------------------------------------
--------------------------------------------------------------------------------------------------------------------------------------------------------------------------------------------------------
-------------------------------------------------------------------------------------------------------------------------------------------------------------------------------M------------------------
-------------------------------------------------------------------------------------------------------------------------------------------------------------------------------------------------------v
------------------------------------------------------------------------------------------------------------------------------------------------------------------------------------?--?-----------T---f
---------------------------------------------------------------------------------------------------------------------------------------------------------------------------------------------------|---f
---------------------------------------------------------------------------------------------------------------------------------------------------------------------------------------------------|---f
------------------------------------------------------------------------------------------------------------------------------------------------------------------------------B--------------------|---f
---------------------------------------------------------------------------------------------------------------------------------------------------------------------------------------------------|---f
---------------------------------------------------------------------------------------------------------------------------------------------------------------------------------------------X-----|---f
m--------------------------------------------------------------------------------------------------------------------------------------------------------------------------------E-E--------XX-----|--EX
XXXXXXXXXXXXXXXXXXXXXXXXXXXXXXXXXXXXXXXXXXXXXXXXXXXXXXXXXXXXXXXXXXXXXXXXXXXXXXXXXXXXXXXXXXXXXXXXXXXXXXXXXXXXXXXXXXXXXXXXXXXXXXXXXXXXXXXXXXXXXXXXXXXXXXXXXXXXXXXXXXXXXXXXXXXXXXX-XXXXXXXXXXXXXXXXXXX|X--X
