-----M--------------------------------------------------------------------------------------------------------------------------------------------------------------------------------------------------
--------------------------------------------------------------------------------------------------------------------------------------------------------------------------------------------------------
--------------------------------------------------------------------------------------------------------------------------------------------------------------------------------------------------------
----T---------------------------------------------------------------------------------------------------------------------------------------------------------------------------------------------------
----|--X---X--------------------------------------------------------------------------------------------------------------------------------------------------------------------------------------------
---?|--------------------------------------------------------------------------------------------------------------------------------------------?------------------------------------------------------
----|------------------------------------------------------------------------------------o---------------------------------------X----------------------------------------------------------------------
----|------------------------------------------------------------------------------------------------------------------------------------------B-------------------------------------------------------v
-X--|----------------------------------------------------------------------------------------B--------------------------------------X------------------------------------------------------------------f
-XXX|XXX-------------------------------------------------------------X--------------------------------------------------------------XX-----------------------------------------------------------------f
----|----------------------------------------------------------------XX-------------------------------------------------------------XXX----------------------------------------------------------------f
----|----X---------------------------------------------X-------------XXX------------------------------------------------------------XXXXX--------------------------------------------------------------f
----|----XX----------------------------------------------------------XXXX-----------------------------------------------------------XXXXX--B-----------------------------------------------------------f
----|XX--XXX---------------------------------------------------------XXXXX----------------------------------------------------------XXXXXX-------------------------------------------------------------f
m---|E---XXXX---E----------------------------------------------------XXXXXX---------------------------------------------------------XXXXXXX------------------------------------------------------------X
XXXX|XXXXXXXXXXXXXXXXXXXXXXXXXXXXXXXXXXXXXXXXXXXXXXXXXXXXXXXXXXXXXXXXXXXXXXXXXXXXXXXXXXXXXXXXXXXXXXXXXXXXXXXXXXXXXXXXXXXXXXXXXXXXXXXXXXXXXXXXXXXXXXXXXXXXXXXXXXXXXXXXXXXXXXXXXXXXXXXXXXXXXXXXXXXXXXXXXXX
