--------------------------------------------------------------------------------------------------------------------------------------------------------------------------------------------------------
--------------------------------------------------------------------------------------------------------------------------------------------------------------------------------------------------------
--------------------------------------------------------------------------------------------------------------------------------------------------------------------------------------------------------
----X---------------------------------------------------------------------------------------------------------------------------------------------------------------------------------------------------
--------------------------------------------------------------------------------------------------------------------------------------------------------------------------------------------------------
--------------------------------------------------------------------------------------------------------------------------------------------------------------------------------------------------------
--XXXXX-------------------------------------------------------------------------------------------------------------------------------------------------------------------------------------------------
--------------------X----------------------------------------------------------------------------------------------------------------------------------------------------------------------------------v
-------------------XX----------------------------------------------------------------------------------------------------------------------------------------------------------------------------------f
-----------X------XXX----------------------------------------------------------------------------------------------------------------------------------------------------------------------------------f
-----T----XX-----XXXX----------------------------------------------------------------------------------------------------------------------------------------------------------------------------------f
-----|---XXX?---XXXXX----------------------------------------------------------------------------------------------------------------------------------------------------------------------------------f
-----|--XXXX---XXXXXX----------------------------------------------------------------------------------------------------------------------------------------------------------------------------------f
-----|-XXXXX--XXXXXXX-----T----------------------------------------------------------------------------------------------------------------------------------------------------------------------------f
m----|XXXXXX-XXXXXXXX-----|--------------------------E----------------------------------------BBBBBBBB-------------------------------------------------------------------------------------------------X
XXXX-|XXXXXXXXXXXXXXXXXXXX|XXXXXXXXXXXXXXXXXXXXXXXXXXXXXXXXXXXXXXXXXXXXXXXXXXXXXXXXXXXXXXXXXXXXXXXXXXXXXXXXXXXXXXXXXXXXXXXXXXXXXXXXXXXXXXXXXXXXXXXXXXXXXXXXXXX------XXXXXXXXXXXXXXXXXXXXXXXXXXXXXXXXXXXX
