-------------------------------------------------------------------------------o-----------------------------------------X-----------------------------------------------o------------------------------
---------------------------------------------------------------B----------------------------------------------------------------------------------------------------------------------------------------
---------------------------------------------------------------------------------------------------------------------------------------------------------------------------------------------X----------
-------------------------------------------------------------------------------X------------------------------------------------------------------------B-----------------------------------------------
-------------------------------------------------------------------------------X----------X----------------------------------------------------------------------------------------?-------------B------
--------------------------------------------T-------------------------------------M------XX----o--------------------------------------------------------------------------------------------------------
-----------------------------T--------------|-------------------------------------------XXX------------------------------------------------------------------------------------------B------------------
-----------------------------|--------------|----------------------------------------XXXXXX-------------------------------------B----------------------------------------------------------------------v
-----------------------------|--------------|-----------------------------------------XXXXX------------------------------------------------------------------------------------------------------------f
-----------------------------|------T-------|-------------T--------------------------XXXXXX------------------------------------------------------------------------?-----------------------------------f
-----------------------------|------|-------|-------------|-------------------------XXXXXXX------------------------------------------------------------------------------------------------------------f
-----------------------------|------|-------|-------------|------------------------XXXXXXXX--------------------------------------------------------X---------------------------------------------------f
-----------------------------|------|-------|------------?|-----------------------XXXXXXXXX------------------------------------------------------------------------------------------------------------f
-----------------------------|------|-------|-----------T-|-----------------T----XXXXXXXXXX------------------------------------------------------------------------------------------------------------f
m----------------------------|------|-------|-----------|-|-----------------|-E-XXXXXXXXXXX-------------------------------------------------E-----E---------------E-----------------E------------------X
X----XXXXXXXXXXXXXXXXXXXXXXXX|XXXXXX|XXXXXXX|-----XXXXXX|X|XXXXXXXXXXXXXXXXX|XXXXXXXXXXXXXXXXXXXXXXXXXXXXXXXXXXXXXXXXXXXXXXXXXXXXXXXXXXXXXXXXXXXXXXXXXXXXXXXXXXXXXXXXXXXXXXXXXXXXXXXXXXXXXXXXXXXXXXXXXXX
