--------------------------------------------------------------------------------------------------------------------------------------------------------------------------------------------------------
------------------------------------------------------------------------------------------------------------------X-----------------------------------------B-------------------------------------------
---X----------------------------------------------------------------------------------------------------------------------------------------------------------------------------------------------------
-------X---------------------------------------------------------------------------------------------------------B--------------------------------------------------------------------------------------
--------------------------------------------------------------------------------------------------------------------------------------------------------------------------------------------------------
-------------------------------------------------------------------------------------------------------------------------------------------------------------BBBBBBBB-----------------------------------
-----------------------------------------------------------------------------------------------------B----------------M---------------------------------------------------------------------------------
-------------------------------------------------------------------------------------------------------------------------------------------------------------BBBBBBBB-X--------------------------------v
----------------------------------------------------------------------------o------------------XXXX------------------------------------------------------------------XX-----------?----------XX--------f
--------------------------------------------------------------------------------------------------------------------------------------------------------------------XXX--------------------------------f
---?---------------------------------------------------------------------------------------------------------------M-------o---------------------------------------XXXX--------------------------------f
-----------------------------------------------------------------------------------------------------------------o------------------------------------------------XXXXX--------------------------------f
----------------------------------------------------------------------------------------------------------------------------------------------------------M-T----XXXXXX---------------------X----------f
----X-----------------------------------------------------------------------------------------------------------------------T-------------------------------|---XXXTXXX--------------------XX----------f
m--XX-----------------------------------------------------------------------------------------E-----------------E-------E---|-----------------------------E-|--XXXX|XXX---E---------------XXX----------X
XXXXXXXXXXXXXXXXXXXXXXXXXXXXXXXXXXXXXXXXXXXXXXXXXXXXXXXXXXXXXXXXXXXXXXXXXXXXXXXXXXXXXXXXXXXXXXXXXXXXXX------XXXXXXXXXXXXXXXX|XXXXXXXXXXXXXXXXXXXXXXXXXXXXXXX|XXXXXX|XXXXXXXXXXXXXXXXXXXXXXXXXXXXXXXXXXXX
