-------------------------------------------------------------------------------------------------------------------------------------------------------------------------------------------------------E
-------------------------------------------------------------------------------------------------------------------------------------------------------------------------------------------------------X
--------------------------------------------------------------------------------------------------------------------------------------------------------------------------------------------------------
-------------------------------------------------------------------------------------------------------------------------------------------------------------------------------------------------------B
--------------------------------------------------------------------------------------------------------------------------------------------------------------------------------------------------------
--------------------------------------------------------------------------------------------------------------------------------------------------------------------------------------------------------
---E------------XT-XX--------E---o-o----?--------------T-B?B?-------BT-o----------X--M----------E-----o-o-----X-XT-o------X--------E--o--X--XXX-TEXo-----X??-ooo-----?-X-X--?BM--B?B--XXXX-----XX--E----
----------M------B-------BMB-----------------------------?-X----------oT-o-------------B?B---------E--E----oT-B-E---------ooo--oooooo--X--?-?B-----------------XXX------------BT-X--------o------------v
------XX-XX-X-------------------Eoo-----MB----oo-o----------------------------T-X---------E-------XXX-B?B------oo--------XXX----oooo-----T--------------o--------------?B?BT----oE---X-T-XX?B?BEEX---MTf
----------------------------E----E--------------?B?B-X-----------MT-------------T-X--X---o-XB?--?B-----------------------------?-XXX-----------------M---------X------oo-----X-X-X--------E---BXXXX----f
------------------------?B?B---XXXX---X--XXXXX-------------o---------XT-XE----ET-T-o-o-?B----------o-o--o-T-XXX---------E-XXX--XXX--X--B-B-oT-o--M--?B?XXXXXXX-XXo--X---XX--B-B-M------XXXX-------BX---f
--------------------------------?B?---XXX---------------ET-X-----------------E-|-|--E------X-------|--?------------EE-----oTEX--------------|--------------------T--?X--XXXX--?-?---BMBX------o--XXX-T-f
--E------XX--X---------------------o--oo-----?E----------|------------|------E-|-|---------X---------------------o---E-oo--|---------------X----------oooB?-?B---|-o------M-M------EE---|----X--XT-B-|-f
--X-X-XX-X--?BXXXX-X-------------T---------X------MB?B?--|------------|--oo-o--|-|--E------------|-|------|-------XX-------|---T-oooooo---X---------E-X------o---|------------------XX--|---B----|---|-f
m----?---------------------------|---B?BX-XX-------------|---------XX-|-|------|-|---------------|-|-B?--------T-----------|---|------X----E|-T-X--------B-BT----|-------B?-?-?-X---|--?B?B?XXXXX|-XX|-X
XXXXXXXXXXXXXXXXXXXXXXXXXXXXXXXXXXXXXX-XXXXX-XXXXXXXXXXXXXXXXXXXXXXXXXXXXXXXXXXXXXXXXXX-XXXXXXX-XXXXXXXXXXXXXXXXXXXXXXXXXXXXXXXXXXXXXXXXXXXXXXXXXXXXXXXXXXXXXXXXXXXXXXXXXXXXXXXXXXXXXXXXXXXXXXXXXXXXXXXX
