-------------------------------------------------------------------------------------------------------------------------------------------------------------------------------------------------------E
-------------------------------------------------------------------------------------------------------------------------------------------------------------------------------------------------------X
--------------------------------------------------------------------------------------------------------------------------------------------------------------------------------------------------------
-------------------------------------------------------------------------------------------------------------------------------------------------------------------------------------------------------B
--------------------------------------------------------------------------------------------------------------------------------------------------------------------------------------------------------
--------------------------------------------------------------------------------------------------------------------------------------------------------------------------------------------------------
---E------------XT-XX--------E---o-o---B?--------------T-BMB?-------BT-o----------X--M----------E-----o-o-----X-XT-o------X--------E--oo----XXX-TEXo-----X??-oo------?-X-X-B?BM--B?B--XXXX-----XX--E----
----------M------B-------BMB---------------------------M-?-X----------oT-o-------------------------E--E----oT-B-E----------oo--oo-o----X--?B?B-----------------?X-------------BT-X--------o------------v
------XXXXX-X-------------------Eoo-----MB----ooooo-----------------o---------T-X---------E-------XXX--?B------oo--------XX-----oooo-----T--------------o--------------?B?BT----oE---X-T-XX?B?BEEX---MTf
----------------------------E----E--------------?BMB-X-----------MT-------------T-X--X---o-XB?-B?B?----------------------------?-XXX-------X---------M---------X------oo-----X-X-X--------E---BXXXX----f
------------------------?B-B----XXX------XXX-X-------------o---------XT-XE----ET-T-o-o-?B----------o-o--o-T-XXX---------E-XXX--XXX--X--B-B-oT-o--M--?B?XXXXXXX-XXo--X---XX--B-B-M------XXXX-------BX---f
--------------------------------MB----XXX---------------ET-X-----------------E-|-|--E------X-------|--?------------EE-----oTEX--------------|--------------------T---X--XXXX--?-?---BMBX------o--XXX-T-f
--E------XX--X---------------------o--oo-----?E----------|----?-------|------E-|-|---------X---------------------o---E-oo--|---------------X----------ooo-?B?B---|-o--------M------EE---|----X--XT-B-|-f
--X-XXXX-X--?BXXX--X-------------T---------X------?B?-M--|------------|--oooo--|-|--E------------|-|------|-------XX-------|---T-oooooo---X---------E-X------o---|-------------------X--|---B----|---|-f
m----?---------------------------|---B?BX-XXX------------|--------XXX-|-|------|-|---------------|-|-B?--------T-----------|---|--X---X----E|-T-X--------B-BT----|-------B--?B?BX---|--?B?B?XXXXX|-XX|-X
XXXXXXXXXXXXXXXXXXXXXXXXXXXXXXXXXXXXXXXXXXXX-XXXXXXXXXXXXXXXXXXXXXXXXXXXXXXXXXXXXXXXXXX-XXXXXXXXXXXXXXXXXXXXXXXXXXXXXXXXXXXXXXXXXXXXXXXXXXXXXXXXXXXXXXXXXX-XXXXXXXXXXXX-XXXXXX-XXXXXXXXXXXXXXXXXXXXXXXXX
