------------o--------?----------------------------------------------------------------------------------------------------------------------------------------------------------------------------------
--------------------------------------------------------------------------------------------------------------------------------------------------------------------------------------------------------
--------------------------------------------------------------------------------------------------------?--------------------------------------------------------------------X--------------------------
------------------------------------------------------------------T-------------------------------------------------------------------------------------------------------------------------------------
------------T----------------------------------------------o------|-------------------------------------------------------------------------------------------------------------------------------------
------------|-?-----------BBBBBBBB-------------------------------X|--------------------------------------XXXXXXXX----------------------------------------------------------------------------X----------
------T-----|----------------------------------------------------X|------------------------------------------------------------------------------T--------------------------o--------------------?????--
----?-|-----|----------------------------------------------------X|X------------------------------------------o-----X----------------------------|-----------------------------------------------?-----v
------|-----|----------------------------------------------------X|XX----------------------------------------------XXT---------------------------|-----------------------------------o---------X-------f
------|-----|-------------------X--------------------------------X|XXX--------------------------------------------XXX|---------------------------|--------------------------------------------XX-------f
------|M----|----------------------------------------------------X|XXXX------------------------------------------XXXX|---------------------------|-------------------------------------------XXX-------f
------|-----|----X------------o----------------------------------X|XXXXX----------------------------------------XXXXX|---------------------------|------------------------------------------XXXX-------f
------|-----|------------------------------------------XX--------X|XXXXXX----------------------------XX--------XXXXXX|---------------------------|-----------------------------------------XXXXX-------f
------|-----|----------T-----------------------------------------X|XXXXXXX------------------------------------XXXXXXX|---------------------------|-----------------X-X--------------------XXXXXX-------f
m-----|??---|------E---|---------------------E-----------E---E---X|XXXXXXXX-------------------------E-------EXXXXXXXX|---------------------------|--------------------E----------------X-XXXXXXX-------X
XXXXXX|XXXXX|XXXXXXXXXX|XXXXXXXXXXXXXXXXXBBBBBBXXXXXXXX-----XXXXXX|XXXXXXXXXXXXXXXXXXXXXXXXXXXXXXXXXXXXXXX--XXXXXXXXX|------X-------XXXXXXXXXXXXX|XXXXXXXXXXXXXXXXXXXXXXXXXXXXXXXXXXXXXXXXXXXXXXXXXXXXXX
