------B---------------------------------------X-----------------------------B--------------------------------------E-----B----------------E----B-----------B-----------------B---------B-------------B--
-----------------------B-----------E---------------B---------------E------------B-B----------B-------------------T--E--------------B---------T----------------------------------------B---------E-------
---------------T---------------------------B------B--|-B-----------------|---------------------------------------|--------E--------B-B-------|---------B------------T----------B-----------B---------B--
X-T------------|--B--E-----------B-----------------------E-----B-------------------------------------------------|--E------------------------|----------------------|-----------------------------------
M--------T-----|--B-----------------E-----E--------------------B---------|-----B---B-----------B-----------------|---------------------------|----------------------|---BE-B------M--B-E------------T---
---------|-----|------------------B---------------------E---B--------B---------M------------E--------B-----------|---------------------------|------------------B---|----------------BB----B--------|---
---------------|--------E--T-----------------T---------B-B---------------------------------------E----------------------------------------------E-------------------|-------B-----------T-------B---|-T-
--B------------|-----------|----B------------|------B---------------B-----------------------------------B----------?---------------------B------------------B-------|------------BB-----|-----------|-|-
---------------|-------------T---B-------B---|------------------------------------B---------------B------------T---E----------------------------B-------------------|-------------------|----------B|---
o-----E-----|--|-----T-------|----B-----E---B-------------------------B------------------------------------------------------------T--B------------B----------B-----|-------------------|-----|-----|--T
------------|--|-----|-------|-----B------------------------------B-------------E---------------B----------T------------?----------|------------|---------E------------------------T----|----------E|--o
-B-----B------T------|-----B-|---------------B-----------------------E-------------------B----B------------------------------------|-----|----B-|-----------------------|---B------|----|---E-------|---
-------B----|-|------|-------|---B------T------------------------------------------------B--B---------------E--------E----B------E-|---B-|---E--|----------------------------------|-B--|--------E--|---
X-----------|-|-----B|-------|-B--------|------------------------------------------------------------------------------------E----B|-----------------------------------------------|--------------------
m-----------|-|------|-------|----------|--B--B------------------------------------M-T----T----------------------o-----------------|-----|------------------------------|-------------------------------
XXXXXXXX--X-XXX-X--XX--X---X-X-X-X-X--X-X--X--X---X-X--X--XX--X-X-X--XX---X--X--XXX-XX----X-X-X-XX---XX---X-X-XXX------X------X----X---X--X---XX--X--X-X-X-X-X-XX--XX---XXX--X---X--X-X-XX--X--XXXXXXXXX
