-------------------------------------------------------------------------------------------------------------B---B--E------------------------------------T----X-------B---T-------------------E---------
----------------------------------------------------------B--------------------B-------B------------------------BT----------------------------------------------------------------------------------E--E
--------------------B----B-----------E-------------B--------E-------------------------------------------B-------------B-------B---------------------X-----------------------T---------------------------
------------B-------------T----------------B--------T--------------------------------------E-------------------------B----------B------B----------T-------------------------B---B--------------------E--
---------?---BB-B-----B---------X-------------------------------------E-B-------E-------------------------------------------------------B-----------------------------------------------------------E---
-------------------------B--------E----B-----E-----B-----------------------------------------E----------------------------------------------B--|-----------T?------B------------------B-----------------
-----------------E-----?----------?-------------------------------------------------------------------------------T----------------------------|---------------------------T------------------------B-B-
---------------B------------BTB-B------------------B--B-|---------------------T---------------------|-------B-----|-EB-------------------------|-----------|---------------|------E----|---------------v
-------------B---------------|------B-B--------|--------|---------------------|------?------------B--------T------|--E-------------B---------------------------E-----------------------|--------T---E---
-----------------------------|-M---------|------------------------------------|---------------------|---------B---|-------------------B-------T|---------------------------|---|-------|--B-----|-------
-----------------------------|-E------------B--|--------|---TE---------------------------------------------|------------B-------------B-------|----------------------------|-E-|-B-----|--B-----|-------
------E-B--BB-----------E----------------------|--------|---|------------------------T------|---E---|------|------|-------T-T-----------------|----------B-|---------------------------|----------------
---B---|----E----------BB-------------T------------B----|---|------B-|--------|---B--------E----BB--|---------------------|-|------------------|--------B--|-E-------------|---|----T-----------------B?
---------------------------E-|--------|------------------------------|-----E--|--B-----------------B-------|------|-------|-|----------------B|--------------------E--------------E----|--B-ET----------
m------|---------------------|--------|-----BE----T-----|--T|-----------------|-------------|-------|------|------|---------|-----B-----------|----------------------B-E--T-------E-|--|--B--|--|--|--E-
X-XXXXX-XX-XXX-X-XXX-XXXX-X-XXX-X-X--XXX-XX-X-X-X--XXX---X---X--X-----XX-X-XXX-X--X-XX--XX-XX------XX-X-XXX-X----XX--X-XXX-XXX-X----X-X--X-X-X-XXX--XX--X-XX-X-XX---X-X------X----X--X-XXX-XX--X--XXXXXX
