-------------------------------------------------------------------------------------------------------------------------------------------------------------------------------------------------------X
-----------------------------------------------------------------------------------------------------------------------------------------------------------------------------------------------------E-X
-----------------------------------------------------------------------------------------------------------------------------------------------------------------------------------------------------E--
-------------------------------------------------------------------------------------------------------------------------------------------------------------------------------------------------------X
-------------------------------------------------------------------------------------------------------------------------------------------------------------------------------------------------------M
--------------------------------------------------------------------------------------------------------------------------------------------------------------------------------------------------------
--------B-E--------?BMB------E-------------?-------------XX-X---T------X-X-------------------ooooo---E----XXX--B?B-MB?B?------?-------------------XXX----?B-XXX-----------------ooooX------------------X
----------E-------------------XX-------oo------oooooo-----------------------B?------------------E--------M---------------B-B-----?-----E------------------T----------oooo---------------E----X-----?B?-v
--------T----E--E----------M--XXXXXX--E--------?--E------------XXX--XTE-----------------------X-XX-XX-----X-X----------------------X-XXXX----MXX--E---------X-X--oo-o-MB?B?--XXX-XX-BMB-------X--------f
-----E-----X-XX---?B-----------XXXX-----XX-------X--------------XX--X-----E------T-X------------------------E--X---------------XX--X-X----XTE----XXX-XX-?--X-----T-M-----------X------------X-XXXX-----f
--X------------MB?-M-?B------------------------------M-?-------------?B?B----------o-------?-?--o-B?---------------?B?B--B-XTEo------T----------?B?B-B?B?---E--------------------------oooo-----------Tf
--E----------oooo------X-----XXXXX-----------o-oT-o-----X-X-BMB-----T-o---T-------M-----E-XXXX-----------?B-----------XX-X-X|XXXX-XXXXX------------ooo--------------E----XXXXXXXT-X-----------------X-|f
----------?---------?---------TEX----XX---------|----------o---X-XXX|--BM-|--X----X-------?B?B?B---XXXX------------XX-X-----|----o--oo-XXX?B?-----X-XX--------E----?B?--|----?--|---------?TEX--------|f
----XXX-----o-----B?-M--------|------------EE--E|---ooo----X-----X-X|--X-E|-------X---------------X-----------X-------------|-----------------------------------MB--------------|----------|-----T----|f
m-----E----XXX---------E-E----|--------B?B-B----|-----MT-----XX-----|-----|-T-M---E----E---T--E---E-B?---X-?B?BMo--MB-------|--------|----oooooX---------------------XX--------?|----------|--X--|--E-|X
XXXXXXXXXXXXXXXXXXXXXXXXXXXXXXXXXXXXXXXX-XXXXXXXXXXXXXXXXXXXXXX-XXXXXXXXXXXXXXXXXXXXXXXXXXXXXXXXXXXXXXXXXXXXX-XXXXX-XXXX-XXXXXXXXXXXXXXXXXXXXXXXXXXXXXXXXXXXXXXXXXXXXXXXXXXXXXXXXXXXXXXXXXXXXXXXXXXXXXXX
