o----------------------------------------------------------------------------------------------------------------------------------------------------------------B--------------------------------------
----T-----------------------------------B---------------B-------------------------E------------------E-----------------B------------------T-------------E---------------E----------------E-----E--------
----|--------E--E-------------------------M-----------------|--B----------B------------------B-------------------------------BB-----------|--------------------------------------------B----------------
----|---B--------------------------------------------------------------------------------------|--------B---------------------------------|-------------------------------------------------------------
----|------------------------------B-------------------------------T---------------------B---B---E---------------B--------T--|------------|---------------X---------------------------------------------
----|------B-----E----E-------------B---------------------B---B----|---------------------------|-----B--------------------|--|---E--------|-------------B----------B------------------------------------
----|----------------------------------------------------------B---|-----M--------------------B-E----------B---B--------E-|--|----------E-|--------------------------------B-B-----------------B-------o
----|-----B------------------------------------------------------T-|-o--------------------B------B-----------------|------|------------B--|-E---------------------------------------------------B------v
----|------------------------------------------------------------|-|------------------------------------------------------|------E----------------B-----------------------------------------------------
-----------------------------------------------------------------|-|----------------B-------------------------------------|--------------------B----------B----------------------|----------------------
X--------B-----------------------------------------------B-------|-|--------------------B--------------------T------------|----B------------?-----------E----------------T-B-----|---------------------?
?----------------------------------------------------------------|-|-------X---------------------------------|------------|---------E-------------B-----B----------------|-------|--B---E------------E--
?-------------------------B-----------B-------T----------B--B----|-|----------------------------|-B---B-------------------|--------------------B-------------------B-------------|----T------------T---B
E----------------T-------------------------T--|----------B---------|-------------------------------|----------------------|-------------------------------|---------------------------|--T---------|----
m-----|----------|-----------B----T--------|--|--------------------|----T------------------ET---|--|-----B--E-E-----------|---------B----------B----------|---------T-----------------|--|--------------
XXXXXXX-X--X-X----X-----XX-XXXXXX-XX-XX-X-X-X-XX---XXXXX-XX-X-X-X--XXXXXX-X-X--X--X-X-XXX--X-X-X-XXX--X-X-XX--X-XX-X-X-X-XXX--X-XX--XX---X-X-XXX---X--X-XXX-XX-X--XXXX-X-X-XX---X-X--X---X-X------XXXXXX
