--------------------------------------------------------------------------------------------------------------------------------------------------------------------------------------------------------
------------------o---------------------------------------------------------------------------------------------------------------------------------------------------------------------o---------------
----------------o---------------------------------------------------------------------------------------------------------------------------------------------------------------------------------------
----------M---------------------------------------------------------------------------------------------------------------------------------------------------------------------------------------------
--T-------------------T---------------------------------------------------------------------------------------------------------------------------------------------------------------------------------
--|-------------------|--X------------------------------------------------------------------------------------------------------------------------------------------------------------------------------
--|T------------------|-XX------------------------------------------------------------------------------------------------------------------------------------------------------------------------------
--||-----------X------|XXX--------------------------------------------------------------------------------------------------------------------------------------------------M--------------------------v
--||----------XX------|XXX-----------------------------------------------------------------------------------------------------------------------------------------------B-----------------------------f
--||----X----XXX-----X|XXX-------------------------------------------------------------------------?-------------------------------------------------------------------------------X-------------------f
--||---XX---XXXX----XX|XXX--------------------------------------------------------------------------------------------------------------------------------------------------------XX-------------------f
--||--XXX--XXXXX---XXX|XXX--------------T-----------------------------------------------------------------------------------------------------------------------------o--X-------XXX-------------------f
--||-XXXX-TXXXXX--XXXX|XXX-------------?|--------------------------------------------------------------------------------------------------------------------------------XX-----XXXX-------------------f
--||XXXXXX|XXXXX-XXXXX|XXX--------------|--------------------------------------------------------------------------------------------------------------------------------XXX---XXXXX-------------------f
m-||XXXXXX|XXXXXXXXXXX|XXX-------------M|--------------------------------------------------------------------------------------------------------------------------------XXXX-XXXXXX-------------------X
XX||XXXXXX|XXXXXXXXXXX|XXXXXXXXXXXXXXXXX|XXXXXXXXXXXXXXXXXXXXXXXXXXXXXXXXXXXXXXXXXXXXXXXXXXXXXXXXXXXXXXXXXXXXXXXXXXXXXXXXXXXXXXXXXXXXXXXXXXXXXXXXXXXXXXXXXXXXXXXXXXXXXXXXXXXXXXXXXXXXXXXXXXXXXXXXXXXXXXX
