--------------------------------------------------------------------------------------------------------------------------------------------------------------------------------------------------------
------------------------------------------------------------------------------------------------------------------X-------------------------------------------------------------------------------------
---X----------------------------------------------------------------------------------------------------------------------------------------------------------------------------------------------------
-------X--X---------------------------------------------------------------------------------------------------------------------------------------------------------------------------------------------
--------------------------------------------------------------------------------------------------------------------------------------------------------------------------------------------------------
--------------------------------------------------------------------------------------------------------------------------------------------------------------------------------------------------------
-----------------------------------------------------------------------------------------------------B----------------M---------------------------------------------------------------------------------
-------------------------------------------------------------------------------------------------------------------------------------------------------------BBBBBBBB-X--------------------------------v
----------------------------------------------------------------------------o------------------XXXX------------------------------------------------------------------XX-----------?----------XX--------f
--------------------------------------------------------------------------------------------------------------------------------------------------------------------XXX--------------------------------f
---?---------------------------------------------------------------------------------------------------------------M-----------------------------------------------XXXX--------------------------------f
-T---------------------------------------------------------------------------------------------------------------o------------------------------------------------XXXXX--------------------------------f
-|--------------------------------------------------------------------------------------------------------------------------------------------------------M-T----XXXXXX--------------------------------f
-|XXX-----------------------------------------------------------------------------------------------------------------------T-------------------------------|---XXXTXXX--------------------------------f
m|-XX-----------------------------------------------------------------------------------------E-----------------E-------E---|-----------------------------E-|--XXXX|XXX--------------------------------X
X|XXXXXXXXXXXXXXXXXXXXXXXXXXXXXXXXXXXXXXXXXXXXXXXXXXXXXXXXXXXXXXXXXXXXXXXXXXXXXXXXXXXXXXXXXXXXXXXXXXXX------XXXXXXXXXXXXXXXX|XXXXXXXXXXXXXXXXXXXXXXXXXXXXXXX|XXXXXX|XXXXXXXXXXXXXXXXXXXXXXXXXXXXXXXXXXXX
