------------------------------------------------------------X--------------------B-----------------------B----------------------------------------------------------------------------------------------
---------------------?-------------------------?-------B--------E--------------B------B-B-------------------------------------------B------------------E----B------------------------------------------X
----------------------------------------------------B------------------------B------------------E----------E---------------------------------------B-----------B---------------------------------------X
------------------------------------B--------------------------B--------------------------B-------------------------E-----------------------------------B-------------------------------B-------B-------
--------------------B--------------------------------------B---------E-?----------------BB--------------------------------------------------------------------------------------------B----------------B
--------------E-E-------------------------------------------------------------------------------------------------------B---------------E---------------------------------------------------------------
----------------------------------------------------------------------------------------------B---------------B------------------------------E------------------------------------------------X---E-----
------------------------------------------------------------------------------------------------------E-------------------------------------------------B--B-----------B-------------------------------v
----B--------------------------------B-------------------|----------E-----------------------E-------X---------B----------B----------------E----T-------------------T----------E-----------|-------------
-------------------E-----------------B---B-B----E--------|---------------------------------B-----B-------------------------------|---------------------------------|----B--------------E--|-T-----------
------B--------------------------T--B----------------------B----------------------------------------------------------E----------|-------------|---------------T-|-|-------------------B--|-|-----------
---TE------------------------B---------------------------|-------------------T----------------B-----------------------E-------------------B-----------------B--|-|--------|--------E--------|----------X
---|-----------------|-----------|-----------|-----------|-----|-B-E------B--||-----------------------------------------E----B-|-|-------------|------------B---------------B--T-|--B-----|------E-----M
E---------------|----|-----------|-----------|------E-------|----------------||----------X-------B---B-------------------------|------------B--|-----------T--B|-|-|-----------|------|---|-|-----------
m------------T--|----|---------T-|-----------|--------------|-------B--------||-----------------------|------EE--------------------------E-----|------B----|---|-|-|---------|-|------|-B-|-|----------B
X-XXXXX------X----X---X-X--XXX-XX-------XXX---XXX-XXXXX-X-X-X-XX-XX----X----X-XXXX---X-X-X-XX-X-X--X--X-X--X---------XX-X---X----X-X-X-X--XX-X-X-X---XX-X----------X----X--XX-------XXXX---X-XX--XXXXXXX
