--------------------------------------------------------------------------------------------------------------------------------------------------------------------------------------------------------
-o---------------------------------------------------------------------------------------------------------------------------------------------o--------------------------------------------------------
----------------------------------------------------------------------------------------------------------------------------------------o---------------------------------------------------------------
----------------------------------------------------------------------------------------------------------------------------------------------------------------------------------------------------X---
-------------------------------------------------------------------------------------------------------------------------------------------------------------------------------------T----------------o-
-T------------------------------------------------------------------------------------------------------------------------------------------------------------------------------XXXX-|------------------
-|-------------------------------------------------------------------------------------------------------------------------------------------------------------------X---------------|------------------
-|------------------------------------------------------------------------------------------------------------------------------------------------------------------XX---------------|-----------o-----v
-|-----------------------------------------------------------------------------------------------------------------------------------------------------------------XXX---------------|-----------------f
-|---------------------------------------------------------------------------------------------------------------------------------------------------?------------XXXX---------------|--X--T-----------f
-|---------------------------------------------------------------------------------------------------------------------------------------------------------------XXXXX------------T--|-----|-----------f
-|-----------------------------------------------------------------------------------------------------------------------------------------------o--------------XXXXXX------------|--|-----|-----------f
-|---------------------------------------------------------------------------------------------------------------------------------------------M---------------XXXXXXX------------|M-|-----|-----------f
-|------------------------------------------------------------------------------------------------------------------------------------------------------------XXXXXXXX------------|--|-----|---o-------f
m|---------------------------------------------------------------------------------------------------------------------------------------------------------E-XXXXXXXXX------------|XX|X-E--|-----------X
X|XXXXXXXXXXXXXXXXXXXXXXXXXXXXXXXXXXXXXXXXXXXXXXXXXXXXXXXXXXXXXXXXXXXXXXXXXXXXXXXXXXXXXXXXXXXXXXXXXXXXXXXXXXXXXXXXXXXXXXXXXXXXXXXXXXXXXXXXXXXXXXXXXXXXXXXXXXXXXXXXXXXXXXXXXXXXXXXX|--|--XXX|XX---XX----X
