-----M---B--BB-----------------------------------------------------B-------------------B-----------------------------------B--------------B-------------B---?-------------------------------------------
o--B--B--B---------B-E----------------------------B--------BTE----------T------------------------------B---------B-BE--B-----------------------------E---------E-B--------B-----T-------BB--------------
-------------B-----------------------BB--------B-----E-----------------------E-B-----B---------------------------------------------------E--------------------------------------B----E-----T----T-----B-
X--B---B-----B--B-------------B----------------------T--------B---B----------B----------T--------B-------------B---------B-----------B--------BE----------------B----B----B-BB----------B-B---B---------
B-----------------------------------------B--------------------------------------T--------BB----------------B---------------B-E-----B---------------------------------------------B-------E-----------B-
B----T-------------E--------E------T----------------?--|----------------BB--------------------E--------------B--------B--------B---------------------------B-B--------B-T---E---T---E----------B--------
-----|---B------------|-B-------------B-B-------B------|----------B--B-T--------T|-----------------------B-------T-----B--------B-E--T----E----------B------------------|-------|----------------B--B---
E----|-----T--------B--------------|--------B----------|-------------B---BB--B--||-----B-TT----B----BT----B-E------------------------------------B----------------------|-------|--E--|----------------v
-----------||-------BB|-----------E|--B-----------B-B--|------------------------||---B--E||------------------------------------------|-------ET---------------------------------|--------------B--------
-----|----------B-----|--T---------|------B----T-------|----|-B--------|-----------------||----------|----B----B-|--B-------B----B----------------------E--------------B|-X-----|---B-|----B--------B---
?---B--B---||---------|--|-B--BB---|------T--E--|-T-B-B--B--|---T------|---B-----|--EB----|------BBB-|-----T|-B------B-----------T-T-|--------------BT-----B---|--------|-------|----T|------B----------
-----|-----||---------|------------|-----E|-B-----|----|---------------|-B------||-T-----||-----TB-B-|-TE--||---B|---------------|---|-----------B------------E|--------|---BB--|----||------B---|------
M--E-|------|---------|--|-B-----------BBT|-B--||----B-|----|---|------------B--||-|---B-||---E-|---B|----B||----|-------B-|-----|------B-----|------|--------------T---|-------------|-----E----|---B--
-----|--B---|-|-------|--------B--B|----E|--B-----|-B----|--|--B|----B-|--B-T---||-|--B--||-----|------|---||---B----------|-----|?|-|-----B--|------|---------|----|-----T-----|-----|---------E---B--M
m----|--B--|----------|--|-----BBB-------|--TB--|-|-B----|--|-T-|-B---------|--B||-|---B-||-----|------|-B-||----|----B----|----B|-|||--------|------|-----B---|---B|-----|-----------|------B---|---E-o
X-XXXXXXXXX--XXX-XXXXXXXXXX----X---XXXXXX-------XXX-----X--XXXXXX----X--XXX-X--XXX-X----XXXX----XX----XX--X-XXXX-X--X-XXXXX--X-X---XX---XXXX-X--X--XX----XX----XXX--XXX---X--XX-X-X------X----X--XXXXXXX
