-----------------------------------E-------E-B-------------------------------------------------------------------------------------------B-------------------------------------------------------------X
X-----B----------------------B-----E-----B---------B--------------------------------------------------------T----------E----------------------E-----B--------------------B------B--B----------------B---
--B-------E---------T-----B--------E-------------------------------------------------------------?----------|--------------E-------------------------------------------------------B----------B------B--
----------------E---|----------------------------E------------------T-B---------T------E--------------------|--------E----------T---------------------B--M------------------------E-------T-------------
-----------B--------|---------------T----------------E--------------|---BB--B---|------B--------------------|-------------------|-----------B-------------------E-------------------------|-------------
o----------------T------------------|-------------------------------|----------B|--------------E--E------------M------------E---|---------B---------------------B-----------------B-------|---------B--o
--------E--------|-------------------B----------------------|-------|----------------------------B-B--------|-------------------|-------o----E----------B-------B----T---------------|----|-------|--B--
--B--------------|---B----------T------------B----------------------|---------------------------------------|---|------------E----------B----------------------------|-T------------------|---------EB-v
-----------------|--------------|-----------------------------B--------B-E-------B------------------B-E---X-|---|-E-------------------------------------------------E|-|-B---B-------------------------o
---------------B----B-----|-----|-------E---B------------T----------------------------|-E---------EB-B----------|--------------|-------------------|-----------------|--------B------------------------?
X-------E-----------------------|--------B---------------|----BET---------------------|--T-E---B----E-------B---|--------------|------B-------------|----------------|-----EE-B-----------------E------?
E----------------E--------|--T--|-----------------B-T----|--|------E------------------|--|----------E-B---------|--------------|-------------------------E-----------|--?--------B---------E------------
--------------E-----------|--|--|-----------B-------|----|--|-------|------E----------|-B|---B------E-----------|--------|---E-|--B---------T-------|-|-------B------|--B--------------|----------------
--------------------------|--|--|---T--------------------|----------------------------|--|-B---B---E------B-----|--------|-----|------------|------E--|------B-------|--------------------B--------|--BB
m----------B----B-----B---|--|--|---|--------B--------T--|--------B-----E----------------|-------------------------B-----|---B-|-B----------|------B|-|--------------|-B---------------|-----------|----
XXXXXXXX---X--X-X--X-X---XX--X--XX-X-X----X-X--XX--X--X--X---X--X------XX--XX--XX-X-X-X--XX--X-XX-XX-X--X-X-X-X-XXXX---X-X-XXX-XXX-X-XXXX-XXXX-X--XX--X----X-XXXXX--XXX-XX-X-X-X-X--X--X-XXX--XX-XXXXXXX
