--------------------------------------------------------------------------------------------------------------------------------------------------------------------------------------------------------
------------------------------------------------------------------------------------------------------------------X-----------------------------------------B-------------------------------------------
---X----------------------------------------------------------------------------------------------------------------------------------------------------------------------------------------------------
-------X------------------------------------------------------------------------------------------------------------------------------------------------------------------------------------------------
--------------------------------------------------------------------------------------------------------------------------------------------------------------------------------------------------------
--------------------------------------------------------------------------------------------------------------------------------------------------------------------------------------------------------
----------------------------------------------------------------------------------------------------------------------M---------------------------------------------------------------------------------
-------------------------------------------------------------------------------------------------------------------------------------------------------------BBBBBBBB-X--------------------------------v
----------------------------------------------------------------------------o----------------------------------------------------------------------------------------XX-----------?----------XX--------f
--------------------------------------------------------------------------------------------------------------------------------------------------------------------XXX--------------------------------f
---?---------------------------------------------------------------------------------------------------------------M-------o---------------------------------------XXXX--------------------------------f
-T----------------------------------------------------------------------------------------------------------------------------------------------------------------XXXXX--------------------------------f
-|--------------------------------------------------------------------------------------------------------------------------------------------------------M-T----XXXXXX--------------------------------f
-|XXX-----------------------------------------------------------------------------------------------------------------------T-------------------------------|---XXXTXXX--------------------------------f
m|-XX-----------------------------------------------------------------------------------------------------------E-------E---|-----------------------------E-|--XXXX|XXX--------------------------------X
X|XXXXXXXXXXXXXXXXXXXXXXXXXXXXXXXXXXXXXXXXXXXXXXXXXXXXXXXXXXXXXXXXXXXXXXXXXXXXXXXXXXXXXXXXXXXXXXXXXXXXXXXXXXXXXXXXXXXXXXXXXX|XXXXXXXXXXXXXXXXXXXXXXXXXXXXXXX|XXXXXX|XXXXXXXXXXXXXXXXXXXXXXXXXXXXXXXXXXXX
