----------------------------------T--------------------------M--------------------B---------------B-----E--------------------------------------------B---------------------B-------------------------E--
---T---------B---BB---B----------------------------------------------E--------------T-----------------------------B----B------------------------------------------E-------------------------------------
----------------------------T--B--------------------------------------------------T------------------------T-----T------T---X---B---E------------------------B------B------------------B-B-T------------
-----B---------------B---------------B---------------MB--------------E--------------------------------------T--------------------T-------B---?------------------B------------------------------T--------
?------------E-------E-----E--B-B--B--M---------------------------B----------B----------------E-----------------------T-------------------------------------------------------B---T-----------------E---
---------B------------------B----T---------------------------------------------------------B--------------------------|---------------------------------------BT------------------|------E--------E-----
B------TE------------E----------------------E---B------------------------------------B----------------------E-----------------------------E--E---------------------B------|-----E------------------|-B--
----B--|------------------E-----B|------------------------X----------E--------------------------B----------B---------------E-----E--E---------B-------B--E--B--|-----E----|-|--T--|-|----T-B-E---------v
M------|----------------B-------------------------T----------B-------------------|------------------------------------|---------------T------------------------------B------|--|-B-------|--------------
------B--------------------------|--------------------|-E---------T-------|-----------B--------------------E------ET----------------|--------------------------|-------|--|---B|--|-|----|-----B--------
------E|--------TT-------|-------|-|----------|---------------------------|------|-B-T--?------E----E-------B------|----E----B------|----B---------------------|------------|-----|-|----|o--B---B------
B------|--------|-------T----------|-----------------||---------|-|-------|------|---|----|-------B--------------------------T------|---------------T---|----------------E|----|--|-|----|---------|--E-
---------------B||---E--||-T-E---|---E--T---------|---|-------B-|------|--|----------|------E----------------------|--|--T---|------|-|--------TT---|---|------|-------|-B|----|--|-|-------B--E---|----
B-----T|--------|--------|-------|-|-B------------|--||---------|------|--|------------T---------E-----|-----------|--|--||-T--T----|-|--------||---|--E------B|-------|--|-|-B|--|----B-----------|----
m-----||--------||-------|-|-----|-|-T--|-------|-|--|--T-------|---------|---------------|------------|------B---E|--|--|--|--|----|-|--------||-T-|---|------|-------|--|-|--M--|----------------|-E--
X-XXXXX--XX----XX---X-XX------XXX--X--XXXX-----X----------XX-----X--XXX-XXX-X-X-X-XXX--XXXXX--X----X-XX--X-X---X-X-------X--X-XXX--XXX--X----X--X---XXXXX--X--XXXX-X----------X-X---XX---XXXXX-X--XXXXXX
