------E-E-----T-----------B--B---------------------------------------B------------E-----------B--B-------------T------------E--E--------B-----E-------------------B-------------------------------------
----B-EB-B-B--|--B----------B---TB----B--|------B---------T-EBB-----------T---------------B---B----------------|-----B---------------B----B-E---T------------------------------------------E------------
--------B---B-|-----------------|-B------|----T-----------|--E-----------E|----T-E-----B----------T------------|--------T-|----E-E--BB----------|---|------------------E--B--------------E----E-------B-
M-------B-----|-----------------|--------|----|---------B-|----TT---------|----|-----E------B-B---|------------|-------B|-------T----B-----BB---|---|----B--BBB-----------T----T------------B-E---------
-------BB-----|-----------B---E-|--------|----|--B-------E|----||--E------|--BM|-----B------------|-----------B|--------|-|-----|-------B-------|---|----------------B----|----|----------------------E-
-------E------|-----------E-----|-E------|----|-----------|----||----B---E|--B-|------------------|------------|--------|-------|--E-B----------|---|---B----|------------|----|---B-E------T--B--------
B--------B----|--|--------------|-B------|----|-----------|----||---------|---B|----------?---B--B|----------BB|--------|-|-----|--------B--B---|--------B---|------------|----|------T-----|-------B---
B--------B-|--|--|-------|---E--|--------|-|--|--E-B--B-B-|----||---------|----|------------------|-----------B|------B-|-|--B--|---------B-----|---|--------|--E---------|----|------|-----|--BE--|---v
--------------|----------|------|--------|-|--|-----------|----||--B-E----|----|------------------|-----------E|--------|-|----B|---------B--T--|--B|--------|------------|--E-|------|-B---|-----------
B-------------|--|-----B-|------|--------|-|--|-----------|---|||-----B---|----|----------------B-|---B---B----|--------|-|-----|------------|--|--E|---B----|-----B---B--|----|----T-|--ET-|-----------
M--------B----|--|-------|------|-----B-B|----|--B--------|---|||------T--|----|---------B--|-----|------------|--------|-|-----|-----------B|--|---|------B-|------------|--B-|----|-|---|-|---B-------
B-------------|--|-B-----|------|--------|---B|-----------|---|||------|-T|----|----------B-|-----|------------|--------|-|-----|-B----------|--|-B-|--------|--E---B--B--|--T-|----|-|--E|-|------|----
-----------|--|--|-E-----|------|-BBB----|-|-E|----------B|---|||---B--|-|-----|------B-----------|------------|-EE-----|-------|-----B------|--|--B|--------|--------E---|--|-|----|-|---|-|-B----|--E-
-----------|--|-B|-------|------|-----T-------|-----B--TB-|---|||-----B|-|-----|------------|-----|----------B-|------B-|-|---T-|------B-B-E-|--|------------|------------|--|-|----|-|---|-|-----B--B--
m---------B|--|--|-------|--T---|-B---|----|--|--------|--|--B|||------|-|-----|------B-----|-----|--------E---|--------|-|---|-|------------|--|-B----------|------------|-E|-|----|-|-E-|-|-----E-----
X-XXXXXX-X----XXX-X-XX-X--X-XXX-XXXXXXXX--X--XXXX--XX-X-XXXXX--XXXX--X-XXXXXX--XX-X--XX--XX---X--X-X-XX---XXX-XXX---XXXX-XXXXXXXXX---XX--X---XX-XXX-XX----XX----XXX-------XXXXX-X--XXXXX-X-XX--X--XXXXXX
