------B----------o----------B-?----------B------------------B-?---------B----------X----------X--X-------------------BX----------B----X-----?X-B-------B------------B----B-----?-----------------------B
o-X-----B----X---X---?-------------------------M-B-----------B----B-----X-----X---B--B-?-XM-BB--------------X----B------------B-------B------------------X-------B---X-B---------?---M-----B-----XBX---B
-E----B---------B-X-----B--------B----o-----------B------M---B----------?--------------------B-------B-----------------BB----------B--B---X------BB---B-----B--------X-----------?--X---------X---------
---M-----B----------------------M----M-----X---------------------------------------B---------------------------B-----------B--X--B---------------------------------E------B--------B---?----BB----B-----
B------M------o-----B-B--------X-----------------XB------MX------------B-B-ME-----M------B------------------BB-------B---B-----------------o-----B-------B-------------------B---------B--X----B-------M
--X------------B--E--BE------------------------------------B---?-----B---X--------E------B-M-X-M---------BX--o-----------E-?---------?-----------X--M------X---M-------X--B--X---------------BB---E----o
?XB----E-------------------M--------------------B--?---oB----B-B-----------E----------------BX--------------B--------------B----XX-------------------B-------B---------X--X--------B--------B?-X-X-----o
---B------BE-------------?----------------?--------X-E------B--------------------X-B------------------BEM------B--B-M---B------B----B------------------M-----BX----------B----X---B-----?-----?----B---v
-------------------?------X----------B----------------------------B--------------------------------M---------E-B-----------B------?--B----------------X------------------------M----------X---B---B-----
-----------------M------------B---XM----------X--B-----B-B--X------M-------B----B------X-----B----------BX------B-B------B-----B------------B------B---?-----------X-------B-----B-B----------------X---
------------------?------------------X----B--B--B-BX---X-BBB-----------?---B---E-B-----B---------B--------B---B----------BE-----------X-?M----B--B------B-----X--M-?---------B---BXX-B--XB---B--B-------
-----?-----------------B--B----X-B-----------BoX----o------E----B---B------------XBB----M------------------------XB----X-------------B--------XXB----B--B------------------------E------------------B--o
----B--B-B---B----B---X-----?----------------------------?------B---BEB---------------B-------X-X---BBB----X----X-----B---?-B-------------B--X------------------B----------B---B-----B-----B---E----B---
-B-BX--E---X-B-X-----B----BB---------X--------B--------B-B-----X------------------X----XE----E----B----------E----X--X---XB--------B--B--------------E--X-------------B-------------------X----------X--
m-----------B------X----X------------------E---X---E-B---------------------M-?--B----------------o----BX---B----B-B-------B------B--------B----------X-----B-BME---B------------E----X-----B---------B-X
XXXXXXXXXXXXXXXXXXXXXXXXXXXXXXXXXXXXXXXXXXXXXXXXXXXXXXXXXXXXXXXXXXXXXXXXXXXXXXXXXXXXXXXXXXXXXXXXXXXXXXXXXXXXXXXXXXXXXXXXXXXXXXXXXXXXXXXXXXXXXXXXXXXXXXXXXXXXXXXXXXXXXXXXXXXXXXXXXXXXXXXXXXXXXXXXXXXXXXXX
