------M------------------BB---------B--------B---E-----X--B---------MBBB----------E---------E-M-------BB------------B--------X-EE--------X----B--B-B----------Xo------------------------------X-X----B-?
-------------------B--B----X---------------B-B------B--B--B----B---------------------E-B------------------------B----B----?------B---------X--------X---BB-B--X--B-------------X----X--B---------------o
B-EB------X---B-B-B--------------BB-------E---------X--B----------X---B----------------M---------------BB--BBX----B----------------X-B-------------B-------------EB--------X----------X-------BB-B-B-X-X
------------X-----B-----------BE---X-------B----X------B----X-------E--X-----------BB---------o---B---B-------------E-X--?----B----X-X-------BX-BBB---B------------------------------------------------B
o---B-----?-------X---B----B-----X----E----------X---------X-----B-----------X------------M--------M---B--X---------B----B----EX----B-------XB---------------------?------------------B----B-BB--E--B---
-B----E----?----------B---B-------B------B---B----M-------------EX-------------------------------X-----X-----X---B--B----------B-----------------------------------X--------X------B----X----XX---------
-----------B-----X-B--------BXX--B-----------B--------------M-------BB------XX---------E--------E---------------X------E-X---X---------B-------?--B--BB---B--------------X---------X-----X----B-X------M
-----------B--------------B----B--------------------------X----X--B-------B-------X----B------------------------------------B--------------------------------------B----B--------B-BX----X-XBB-B-------v
-------X---B------------B--E--------------------?------BB--------B-------EE-------XXB-----------------M-------------X-------------B-----------B------------------------B------BEBB----B-------------B--B
--------X----------X-------------------------X-E-----------------EBB----------M----B------------B---B-B--BB---------?---B-------?--------B--------------B----X-------X-------------B-------B------------
X-------------------B----M-----X------------------------X-BB--XB-----B-----BX---------EB-B-----X--XXMB------------B--BX----X---------E-------------B-B------------------E------B-B------------B-X--B----
--------X-------B---X----B-------X--------B------------B-----------BBB------B--X-----B-B----B---------BB--------?--B-----B---E-------B-------------------------------------BB--------------B-------B----
----BB----E--XB-----B--------------XE-B-------B---X----B----B-------------B-------------B----------------------------B--------XB------X---X-XB-B--M-B----------B--B--------------X-B-M---------XEB------
-----B-------------B------------------X------------B---B---E-------------B------------------BB----E?----M-------E----E----------------X--B--------------------------------------------------------B-BB--
m--------------------------MB------------B--------------------------------B-X------------M--X---X------------------X---B---------------------------------E---X-----B-----------o------------------------
XX--XXXX-X---XX-XXXXX-XX--XXXX-X-XXXX-XX-XX-X---XX-XXX-X-X-XXX-X--XX-XXXXXXXXXXX-XXX--XXXXXXXXX-XXXX-X-XXX-XXXX-XXXXXXXXXXXXXXXXXXXXXXXXXXXXXX--X-XXX-XX-X-X-X--XXXXX--XXXXX-X-XXXX-X--XXXXX--XXXXXXXXXX
