--------------B----------------------B------------------------------E---------T-------B-------------------------------------------E-------------------------------------T-----E-------------------------
o-----B-------------------------------B---E---B--------------------B--------B--------B--------------------T--------T---------------------B-------BB----------------------------B------B-----------------
------T------T----------------------------B--------------------E------?---------T----------E-----------------------------E--------------------------------------T--------B---B-----B----------------B---
o------------------BE-B--------------------------------B---------------------------------E----------------------E-----------------B------------------------B----------B-------B-------T--T--------------
-------------------------?-------------------------------------------B----E----------------------------------------B-?B-------------------------------------------E---T----------B--------------B-------
o-----------------------------------------B-----------------T---------------------------------------BB-----B-EB------B------B--------T------------------------------------------E-------E----B----------
-----B---T-------EE-----------------T--------------------------------------------------------------------------------------B------?E-----------------------------E-----------------------B---B--------T-
-----------------------------E---------B---B----B-------E---------------B---T-B--------X-------------------------------------B---------B---------------E------E-o------B------B---------------------E--v
--------------------------------------------------B-------E--------------------E-------E------------------------------------------------------B---------------------------------------------------------
---B--E----------B------------------------------------------------------------------------------B--------B--------------B--------------------------------------------------B----------------------------
o----------B---------E--------------------------------------------------------B----B---------------------------------------------E----------|-------o--------------------------------B------E------E----
-----------B--------------------B-B--------------------B----------B--B-B--M----------------B------T--T--------------------------B-----------|----------------------------X------------E-----------------
X--------------E-B-------------------------T-----------------E----B------------------------------------------------B------------E--B--------|--B-E-----------------------------E------------------------
----------B-B------------------------------|--------------------T----|----------E--------------BE-|--|---B-B--------------------------------|-----T--------------------------------------T------------E-
m--B---------------------------|-----------|--------------------|------------B--B----E------------|--|------BB----------B-B--T---------E----------|--------------------------B-------------------B-----M
X-XXXXXX---X-X--XXX-XX-X--XX--X-X-X-XXX-XX-X-X--X-X--X----X--XXX-X-X-X-----X--XXX--X----X-XXX-XXX-XXXX-X-X-----X-X-X--X--X-X----X--X---X---XX---X--XXXXX----XX-XX--X----XX---X--X-----------X--XX-XXXXXX
