--------------------------------------------------------------------------------------------------------------------------------------------------------------------------------------------------------
-----------------------------------------------------------------------------------------------------------------------------------------------------------------------------------------------------E--
--------------------------------------------------------------------------------------------------------------------------------------------------------------------------------------------------------
-------------------------------------------------------------------------------------------------------------------------------------------------------------------------------------------------------X
-------------------------------------------------------------------------------------------------------------------------------------------------------------------------------------------------------X
-------------------------------------------------------------------------------------------------------------------------------------------------------------------------------------------------------X
-------------------------XXX------------------------------------XXX-----ooo-------------------------B?B?--E-------------------------------------------------E-----------XXXX---------o---X-----T-X-----o
--------X-X----------------E-X---X-------------------XXXXX----------------E-------------------------------------------B?B------EE---------------X--Xo-o----------XT---------------E--------------------v
---X---------------------------------------------------oooM-?-?B--------E----?--------------?B-MB-----------------?--------X-B-B?B----X--------X-----B--------XXXXX--------------XXXXXX-X-E-M-------XT-f
---X-------------B?B-X-----------------------E---------------------X-X--------------?BM----XT-X-----oooE-BMB-----------X------------X--B?B?--XXXXX-----------X-XX--E----------oo--------E----B--------Xf
--------------E-------------X---XX-------------XXX--------XX----------------------------------------------------T-X-----------X----------------X----------------------------T-X------o--E------X------Ef
---------------------------------------------XXX-X----------------------------------------T---------------------|----------X-Xoo-E------?B?B??B---?-?B?X-----X-E---?B?------|--------------------------f
------B?-----------------------------oT-ET-------X-XXXX----oooo----------o---------|-E-X--|--E-------------E----|--|-------X--B?----XXXX----X--E------oooo---ooo---X--B?B?--|-oT-X-----?BT-X-XXXX--X---f
----------X-X-XXX---ooo------------E--|--|-M--------------------------B?B----------|---XX-|-------|-E-----?-----|--|----oT------E-----------------T---------E--------B?BXXX-|--|-X-------|----X--------f
m-----------------XX-----------B------|--|-----------------------oo--o--------X--XT|---XXX|-T-X---|-------------|--|-----|-EX---X--oooB-----oo-o--|----------------T-----XX-|--|---------|---X---X-XX--X
XXXXXXXXXXXXXXXXXXXXXXXXXXXXXXXXXXXXXXXXXXXXXXXXXXXXXXXX--XXXXXXXXXX-XXXXXXXXXXXXXXXXXXXXXXXXXXXXXXXXXXXXXXXXXXXXXXXXXXXXXXXXXXXXXXXXXXXXXXXXXXXXXXXXXXXXXXXXXXXXXXXXXXXXX--XXXXXXXXXXXXXXXXXX-XXXXXXXXX
