-------------------------------------------------------------------------------------------------------------------------------------------------------------------------------------------------------B
--------------------------------------------------------------------------------------------------------------------------------------------------------------------------------------------------------
--------------------------------------------------------------------------------------------------------------------------------------------------------------------------------------------------------
--------------------------------------------------------------------------------------------------------------------------------------------------------------------------------------------------------
--------------------------------------------------------------------------------------------------------------------------------------------------------------------------------------------------------
-------------------------------------------------------------------------------------------------------------------------------------------------------------------------------------------------------X
--T------------------------------------------------------E----------------T-X------------E--X-----------T--------------?B------------------------E---X-----------XXXX---------------E-------------------
----------------------------------------------?B?B?---X---XXXXX-------------E-XT-X---------o-ooo------------E-----------------------------------?BMB-XX----E-------------------------------------------v
-----------------------------------------XX----------------X--XX---M------------E-------X-X----------B?B-----------E------E--------------------------------E---B?B-----------oooo-------EB---?B?-?-----f
--X------------?---------o-ooX------------B?B?----------E------------------------------------X---X?BB?B------o-------------------oooo-----------oooT-----------T--XT-----------T-X---T--XEXX--X----XX--f
----?---------X------X--XX--XX--------E--------------------------E?-M---------XX----E---BMB--------------E-------------------?B?-----oT------X--BMB-------------------T-o----XXX------XXX?B----o----XX-f
-------o-ooooooooXX---X----X--------------------XX-----E--------------------M--E------------------------X----------------X------------|--X-X----|----?B?--------X-----|----XX---o---------XT-----T-----f
----ooo---E--E--------------------------o------------X--X------XX-XXX--XXT-|----------BT---oo-----------XX------?B?-?B---E-------X---X|---E-----|---XX--X--------?B?--|--X---------------T-|-----|---X-f
----E---------------E---B?B?----E-XT-X-----X-?-E--XX--X-X------?-XT-M----|-|-E-X------X|----T-M----B?------?-------EXXX------------M-M|---------|-XXXX---X|XX---------|-----------X------|-|---M-|-----f
mXT-M--------------X---------------|-------------E--------E-------|--o---|-|-E-|-ooo?--|----|---------------?B?B---XX----XXX----------|---------|-----XXX-|------B-B--|-X----X-XXXX-X-X--|-|-----|-----X
XXXXXXXXXXXXXXXXXXXXXXXXXXXXXXXXXXXXXXXXXXXXXXXXXXXXXXXXXXXXXXXXXXXXXXXXXXXXXXXXXXXXXXXXXXXXXXXXXXXXXXXXXXXXXX---X-XXXXXXXXXXXXXXXXXXXXXXXXXXXXXXXXXXXXXXXXXXXXXXXXXXXXXXXXXXXXXXXXXXXXXXXXXXXXXXXXXXXXX
