--------------------------------------------------------------------------------------------------------------------------------------------------------------------------------------------------------
--------------------------------------------------------------------------------------------------------------------------------------------------------------------------------------------------------
-------------------------------------------------------------------------------------------------------------------------------------------------------------------------------------------------------o
------------------------------------------------------------------------------------------------------------------------------------------------------------------------------------------------------EX
--------------------------------------------------------------------------------------------------------------------------------------------------------------------------------------------------------
--------------------------------------------------------------------------------------------------------------------------------------------------------------------------------------------------------
------------------oo-XX---------B--------------------XXX---E---XX----?----XX------------E-XX---X------------?B?B-----B?B-X---?-------XXXX--?-B?-M------X----------E---T---T---X-XXX----------?-XXXXX----
--------E------?------------------------T-ooooooo---oXX-X----------------E-------E---MB?--B?B-----------------------------------XX--------E------------X----?-XXXX--------E-----?B?BXXXX------XXXXX----v
--------------------------o---------------B?---T-X-----XX-------X-XX-----?B?B?--------------------XX------XXXX--?B?-E---T-----------X----XX-X-----------?----XXX--------E------------X-XX----X---------f
----------E--------------------E----EE------?B----------------XXXX------XXX-------E-----B?-?B----?-?-?----E----o?B----?--------------------E---------------X-----------XT-X--B-B-----XX--------B-------f
------E--EB--?B------?B?B?-----XTEXXX-------------XX--------X-X-----------------XXX-?-?-------X---?----------------E------oo--XXX------------E--------------XX-M-------XXXXX---------------E---XX-XXX-Mf
--?-?B?-?---XX-------XXXX--M-------XXX----T-?---------------------?B-B--------------MB?-?-X--XXX---X-----?-------X------------XT-o?------------B?B---?BMB---ME--EXX-----XX---B?B?---------E------------f
---T-o-XT-X---------E---X---------------o-|-T-M-XXXX---------------T--------X-X--E----XX---E-E-----X---------?-XT--E----XXXX--E|---ooo-XXXX?------B-XX--------XX-XXXX--?-----X--XXX-------X---X--------f
---|----|---B?B?M-------?B?B---------E---E|-|--?B?--------------E--|------?B?-?B--B?-?B----XXX------oMB--T-X----|--------------|----oo---E---?-B----------------XXXX--XXX-----------------oT-XXXoo-----f
m--|----|--------------o---X----|-----MBMB|-|--------------?B----M-|-----------EEE-------E------E-------E|------|--------------|-------E----------XT-X----X-XX-X-----?B?B?-----------------|---M---XXX-X
XXXXXXXXXXXXXXXXXXXXXXXXXXXXXXXXXXXXXXXX-XXXXXXXXXXXXXXXXXXXXXXXXXXXXXXXXXXXXXXXXXXXXXXXXXXXXXXXXX-XXXXXXXXXXXXXXXXXXXXXXXXXXXXXXXXXXXXXXXXXXXXXXXXXXXXXXXXXXXXXXXXXXXX-XXXXXXXXXXXXXXXXXXXXXXXXXXXXXXXX
