B--|------B|-T-----------?-|BBE-------------------T--B-----B---?|---------M------B---TM--|--------X--X---?---MM------------B-BT--|-----B-----------E--o?---------------------M-------T--?----E-----T----
---|--o--B-|T|X------------|B--?----oX---------T--|-------------|----------TT--B--T--|-|---------B-B---TB-------T--B------X---|E-|T---------T---X--o----B--------------------------X-|T---B-B-X--B-|----
----B------|-|----o-X------X-----------X----------|-T-------B-----BX----E---|----X|B-|X------------X---|--------|-----------B-|X--|-----------------B----------XBX----B-BT---X--------|X---B-B-B---|----
-------BB--|-|-------T--------------E----M------B-|--------B-------?X-------EE----|--|--X------B-----B-|--------|-E------E-------B|TB----E------TB-----B---B--X-E--BB--X-|--E--B---B-E|--B---BB----|---?
--B-----B--|-|-BB----|--B-X----B--B--M-----B------------oo--------------EB--------|-----XX---------o-M--B-------|B----TT----------||----B-------|-----MX--XX------M------|----X-------|X---B-----?-|-TET
----------?-E|-----EB-?-----------B-T------------X-----------X-B-TB---XX----BE----|-------------EX--------------|-----|--BB-------||------B-B---|B--B-------B------------|-X-------XB-|---T-B---X--|-|-B
B-XX-----?---BB---B--------------X--|-------B---?---|-X---BM-----o------BX------XBBBB-B----------X------M-------|-X-M-|XX-----------M-------TT-B|-----------B-B------E---|-B-------------X|------B-|-|--
---?---------------------BB---X---?B|--B------oX----|-?----------|------E----------B-------M----B-B------B------|T--B-|----B--?----B|-------||--|E-------T---------------|--------E-------|-------X|-|-v
B-----oo-----X-------------E--------|----B----------|--------B---------------X-?--T----------M---------B-X-X-X---|--?--X--B-B----E----------||--|BB-M---X|B---B--BXB---------M------------|-T------|-|--
-----M---?----X-----------B----B-?-------------?-----------B--------------M-------|---B--------B-----BM--B-X-B---|----------B----X---?------||--|----------B-X--------X----B-?-----------T|-|------|E|--
-X---------------XX----BBM----------E-------B?------E-----------|--------E---X---X|-X------------------------B---|---B-B--B-----B-----------|---|B-M-B----BE-----------------------------||-|-?B---?-|-E
------------T---------------X-M----------E---BB-B------B----T-B-|-B--------o------M-E--------------------B----------X-X----------TT----B----||B-|----X-XB---------X-E-----B-B-E---E------||-|--------|--
------------T---B---------------X-------------------B---M-------|--------------------B--------EB-------------B--------o----X----B||---------|--M|------B----B--------B--B-X--X-----B-----|--|--------|--
-----E--B---|XX--B-M--------------------E-X---BT----T-------B---|-E-E-B-----------|----T-T--------------B--------E--X-----X--B---||------M--|B--|--------------B-----BX--XX-----B----T-?-|-B|B------X|--
m-BT----B---|-----B--------T------B-----B-X-BB-|-X--|E--B----B--T-?---------------|----|X|B---------E----X--X------B-------------T|B----B---TBB-|XB-B-----X----X---X--------X-----?--|---|-------XBT-T--
XXXT-X---oXT|XXMXMXXX--X-XXTX--XXXX----XXX?-XXXTXXTXTXX-X-X-XXXX|XXXXXXXXXX|X-X-XXTX-XXT-|XXXXX?XX-XXXXTXXXXXXX-TXXXXXX---XXXXX-X|TX-X--XXXX|XXXX-XXXXXXX--X-XXXXXXXXXXXXTXXX-XXXXXXX|TXXXXXXXXXXXXXX|XX
